Timestep,Iteration,Total Reward,Suboptimal Arms,Total Regret,Zeros Count,Ones Count
2,1,0.0,1,0.01,2,0
3,1,0.0,2,0.01,3,0
100,1,44.0,48,0.24,56,44
200,1,91.0,59,0.3,109,91
2000,1,978.0,1152,5.76,1022,978
10000,1,4996.0,5809,29.05,5004,4996
20000,1,10093.0,10104,50.52,9907,10093
40000,1,19993.0,16936,84.68,20007,19993
60000,1,29919.0,28691,143.46,30081,29919
80000,1,39812.0,41071,205.36,40188,39812
100000,1,49750.0,49275,246.38,50250,49750
2,2,1.0,1,0.01,1,1
3,2,2.0,2,0.01,1,2
100,2,49.0,59,0.3,51,49
200,2,99.0,115,0.58,101,99
2000,2,1035.0,890,4.45,965,1035
10000,2,4995.0,4598,22.99,5005,4995
20000,2,9947.0,9876,49.38,10053,9947
40000,2,19870.0,18301,91.51,20130,19870
60000,2,29947.0,24085,120.43,30053,29947
80000,2,39811.0,32891,164.46,40189,39811
100000,2,49725.0,38155,190.78,50275,49725
2,3,1.0,1,0.01,1,1
3,3,1.0,1,0.01,2,1
100,3,42.0,33,0.17,58,42
200,3,83.0,92,0.46,117,83
2000,3,977.0,1056,5.28,1023,977
10000,3,5001.0,5018,25.09,4999,5001
20000,3,9939.0,8972,44.86,10061,9939
40000,3,19927.0,15762,78.81,20073,19927
60000,3,29793.0,23394,116.97,30207,29793
80000,3,39696.0,32844,164.22,40304,39696
100000,3,49750.0,37069,185.35,50250,49750
2,4,1.0,1,0.01,1,1
3,4,2.0,1,0.01,1,2
100,4,50.0,42,0.21,50,50
200,4,107.0,63,0.32,93,107
2000,4,983.0,724,3.62,1017,983
10000,4,4950.0,4177,20.89,5050,4950
20000,4,9909.0,8440,42.2,10091,9909
40000,4,19750.0,13153,65.77,20250,19750
60000,4,29815.0,19893,99.47,30185,29815
80000,4,39696.0,27747,138.74,40304,39696
100000,4,49606.0,35598,177.99,50394,49606
2,5,0.0,1,0.01,2,0
3,5,0.0,2,0.01,3,0
100,5,48.0,52,0.26,52,48
200,5,100.0,96,0.48,100,100
2000,5,1007.0,797,3.99,993,1007
10000,5,4916.0,4694,23.47,5084,4916
20000,5,9948.0,7387,36.94,10052,9948
40000,5,19957.0,20510,102.55,20043,19957
60000,5,29846.0,29702,148.51,30154,29846
80000,5,39847.0,38634,193.17,40153,39847
100000,5,50011.0,45959,229.8,49989,50011
2,6,2.0,1,0.01,0,2
3,6,3.0,2,0.01,0,3
100,6,49.0,44,0.22,51,49
200,6,101.0,108,0.54,99,101
2000,6,996.0,1304,6.52,1004,996
10000,6,4990.0,4497,22.49,5010,4990
20000,6,9977.0,10004,50.02,10023,9977
40000,6,19982.0,18796,93.98,20018,19982
60000,6,29869.0,23190,115.95,30131,29869
80000,6,39806.0,27634,138.17,40194,39806
100000,6,49879.0,30352,151.76,50121,49879
2,7,1.0,1,0.01,1,1
3,7,2.0,2,0.01,1,2
100,7,56.0,53,0.27,44,56
200,7,112.0,115,0.58,88,112
2000,7,1013.0,1002,5.01,987,1013
10000,7,5020.0,3890,19.45,4980,5020
20000,7,9914.0,8253,41.27,10086,9914
40000,7,19958.0,16040,80.2,20042,19958
60000,7,29843.0,23268,116.34,30157,29843
80000,7,39791.0,31682,158.41,40209,39791
100000,7,49755.0,34912,174.56,50245,49755
2,8,2.0,1,0.01,0,2
3,8,3.0,2,0.01,0,3
100,8,58.0,34,0.17,42,58
200,8,105.0,61,0.31,95,105
2000,8,991.0,834,4.17,1009,991
10000,8,4926.0,4985,24.93,5074,4926
20000,8,9914.0,7729,38.65,10086,9914
40000,8,19908.0,11416,57.08,20092,19908
60000,8,29761.0,18584,92.92,30239,29761
80000,8,39744.0,27549,137.75,40256,39744
100000,8,49879.0,28614,143.07,50121,49879
2,9,2.0,1,0.01,0,2
3,9,2.0,2,0.01,1,2
100,9,55.0,66,0.33,45,55
200,9,101.0,126,0.63,99,101
2000,9,970.0,1021,5.11,1030,970
10000,9,4897.0,5209,26.05,5103,4897
20000,9,9811.0,9322,46.61,10189,9811
40000,9,19765.0,18771,93.86,20235,19765
60000,9,29665.0,27338,136.69,30335,29665
80000,9,39596.0,33560,167.8,40404,39596
100000,9,49541.0,44339,221.7,50459,49541
2,10,1.0,1,0.01,1,1
3,10,1.0,2,0.01,2,1
100,10,37.0,76,0.38,63,37
200,10,86.0,142,0.71,114,86
2000,10,974.0,924,4.62,1026,974
10000,10,4946.0,6544,32.72,5054,4946
20000,10,9877.0,12937,64.69,10123,9877
40000,10,19629.0,26111,130.56,20371,19629
60000,10,29600.0,29283,146.42,30400,29600
80000,10,39711.0,29854,149.27,40289,39711
100000,10,49689.0,35566,177.83,50311,49689
2,11,1.0,1,0.01,1,1
3,11,1.0,1,0.01,2,1
100,11,48.0,44,0.22,52,48
200,11,98.0,71,0.36,102,98
2000,11,1006.0,1140,5.7,994,1006
10000,11,4992.0,4968,24.84,5008,4992
20000,11,9949.0,9550,47.75,10051,9949
40000,11,19920.0,22995,114.98,20080,19920
60000,11,29767.0,35613,178.07,30233,29767
80000,11,39696.0,40602,203.01,40304,39696
100000,11,49623.0,53937,269.69,50377,49623
2,12,1.0,1,0.01,1,1
3,12,1.0,2,0.01,2,1
100,12,53.0,42,0.21,47,53
200,12,105.0,78,0.39,95,105
2000,12,1038.0,886,4.43,962,1038
10000,12,5040.0,4225,21.13,4960,5040
20000,12,10001.0,7880,39.4,9999,10001
40000,12,19913.0,17586,87.93,20087,19913
60000,12,29858.0,26236,131.18,30142,29858
80000,12,39958.0,33916,169.58,40042,39958
100000,12,49842.0,42545,212.73,50158,49842
2,13,1.0,1,0.01,1,1
3,13,1.0,2,0.01,2,1
100,13,39.0,43,0.22,61,39
200,13,83.0,87,0.44,117,83
2000,13,1013.0,938,4.69,987,1013
10000,13,5041.0,3937,19.69,4959,5041
20000,13,10041.0,6792,33.96,9959,10041
40000,13,19974.0,12825,64.13,20026,19974
60000,13,29908.0,22327,111.64,30092,29908
80000,13,39913.0,28962,144.81,40087,39913
100000,13,49980.0,33398,166.99,50020,49980
2,14,1.0,1,0.01,1,1
3,14,2.0,1,0.01,1,2
100,14,55.0,67,0.34,45,55
200,14,105.0,114,0.57,95,105
2000,14,1025.0,874,4.37,975,1025
10000,14,4944.0,5014,25.07,5056,4944
20000,14,10015.0,8689,43.45,9985,10015
40000,14,20003.0,14904,74.52,19997,20003
60000,14,29982.0,25289,126.45,30018,29982
80000,14,39927.0,33499,167.5,40073,39927
100000,14,49959.0,39968,199.84,50041,49959
2,15,1.0,1,0.01,1,1
3,15,1.0,2,0.01,2,1
100,15,49.0,69,0.35,51,49
200,15,101.0,102,0.51,99,101
2000,15,1013.0,967,4.84,987,1013
10000,15,4954.0,4579,22.9,5046,4954
20000,15,10028.0,9708,48.54,9972,10028
40000,15,19928.0,19474,97.37,20072,19928
60000,15,29794.0,27540,137.7,30206,29794
80000,15,39788.0,31829,159.15,40212,39788
100000,15,49798.0,40637,203.19,50202,49798
2,16,1.0,1,0.01,1,1
3,16,2.0,1,0.01,1,2
100,16,51.0,37,0.19,49,51
200,16,109.0,97,0.49,91,109
2000,16,999.0,840,4.2,1001,999
10000,16,5032.0,4420,22.1,4968,5032
20000,16,10066.0,9757,48.79,9934,10066
40000,16,20102.0,16337,81.69,19898,20102
60000,16,30020.0,21856,109.28,29980,30020
80000,16,39886.0,28926,144.63,40114,39886
100000,16,49787.0,33297,166.49,50213,49787
2,17,2.0,1,0.01,0,2
3,17,3.0,2,0.01,0,3
100,17,49.0,54,0.27,51,49
200,17,97.0,119,0.6,103,97
2000,17,966.0,1079,5.4,1034,966
10000,17,4927.0,4521,22.61,5073,4927
20000,17,9887.0,8275,41.38,10113,9887
40000,17,19908.0,17515,87.58,20092,19908
60000,17,29761.0,22667,113.34,30239,29761
80000,17,39892.0,30336,151.68,40108,39892
100000,17,49809.0,35146,175.73,50191,49809
2,18,1.0,1,0.01,1,1
3,18,1.0,1,0.01,2,1
100,18,43.0,58,0.29,57,43
200,18,95.0,111,0.56,105,95
2000,18,975.0,957,4.79,1025,975
10000,18,4991.0,3624,18.12,5009,4991
20000,18,9839.0,6241,31.21,10161,9839
40000,18,19828.0,10042,50.21,20172,19828
60000,18,29762.0,13073,65.37,30238,29762
80000,18,39762.0,14811,74.06,40238,39762
100000,18,49724.0,26573,132.87,50276,49724
2,19,0.0,1,0.01,2,0
3,19,1.0,2,0.01,2,1
100,19,51.0,53,0.27,49,51
200,19,98.0,90,0.45,102,98
2000,19,1017.0,677,3.39,983,1017
10000,19,4976.0,4323,21.62,5024,4976
20000,19,10049.0,8103,40.52,9951,10049
40000,19,20234.0,17705,88.53,19766,20234
60000,19,30184.0,25646,128.23,29816,30184
80000,19,40140.0,31272,156.36,39860,40140
100000,19,50201.0,33308,166.54,49799,50201
2,20,1.0,1,0.01,1,1
3,20,1.0,2,0.01,2,1
100,20,45.0,40,0.2,55,45
200,20,90.0,75,0.38,110,90
2000,20,1017.0,792,3.96,983,1017
10000,20,4972.0,4306,21.53,5028,4972
20000,20,9994.0,9314,46.57,10006,9994
40000,20,20089.0,19347,96.74,19911,20089
60000,20,29977.0,28826,144.13,30023,29977
80000,20,39721.0,35494,177.47,40279,39721
100000,20,49784.0,36225,181.13,50216,49784
2,21,0.0,1,0.01,2,0
3,21,1.0,2,0.01,2,1
100,21,45.0,54,0.27,55,45
200,21,88.0,129,0.65,112,88
2000,21,1010.0,832,4.16,990,1010
10000,21,4955.0,3874,19.37,5045,4955
20000,21,9928.0,9073,45.37,10072,9928
40000,21,19929.0,17256,86.28,20071,19929
60000,21,29901.0,24287,121.44,30099,29901
80000,21,40036.0,35136,175.68,39964,40036
100000,21,49840.0,47873,239.37,50160,49840
2,22,0.0,1,0.01,2,0
3,22,0.0,2,0.01,3,0
100,22,48.0,39,0.2,52,48
200,22,96.0,74,0.37,104,96
2000,22,1012.0,621,3.11,988,1012
10000,22,4990.0,3413,17.07,5010,4990
20000,22,10000.0,7425,37.13,10000,10000
40000,22,19899.0,13876,69.38,20101,19899
60000,22,29948.0,20747,103.74,30052,29948
80000,22,39909.0,28761,143.81,40091,39909
100000,22,49812.0,35626,178.13,50188,49812
2,23,2.0,1,0.01,0,2
3,23,2.0,2,0.01,1,2
100,23,52.0,51,0.26,48,52
200,23,107.0,109,0.55,93,107
2000,23,1012.0,956,4.78,988,1012
10000,23,4982.0,4120,20.6,5018,4982
20000,23,9900.0,7840,39.2,10100,9900
40000,23,19936.0,16238,81.19,20064,19936
60000,23,29911.0,23387,116.94,30089,29911
80000,23,39774.0,32893,164.47,40226,39774
100000,23,49820.0,38492,192.46,50180,49820
2,24,2.0,1,0.01,0,2
3,24,2.0,2,0.01,1,2
100,24,49.0,26,0.13,51,49
200,24,94.0,57,0.29,106,94
2000,24,967.0,1038,5.19,1033,967
10000,24,4916.0,5756,28.78,5084,4916
20000,24,9844.0,11692,58.46,10156,9844
40000,24,19862.0,26137,130.69,20138,19862
60000,24,29833.0,38545,192.73,30167,29833
80000,24,39774.0,47421,237.11,40226,39774
100000,24,49592.0,62255,311.28,50408,49592
2,25,1.0,1,0.01,1,1
3,25,1.0,1,0.01,2,1
100,25,48.0,42,0.21,52,48
200,25,90.0,67,0.34,110,90
2000,25,991.0,966,4.83,1009,991
10000,25,4992.0,5533,27.67,5008,4992
20000,25,9956.0,10905,54.53,10044,9956
40000,25,19934.0,19582,97.91,20066,19934
60000,25,29957.0,30474,152.37,30043,29957
80000,25,39912.0,42360,211.8,40088,39912
100000,25,49841.0,51429,257.15,50159,49841
2,26,1.0,1,0.01,1,1
3,26,1.0,1,0.01,2,1
100,26,48.0,39,0.2,52,48
200,26,90.0,66,0.33,110,90
2000,26,990.0,608,3.04,1010,990
10000,26,4929.0,2787,13.94,5071,4929
20000,26,9930.0,6418,32.09,10070,9930
40000,26,19906.0,12468,62.34,20094,19906
60000,26,29875.0,18093,90.47,30125,29875
80000,26,39848.0,26806,134.03,40152,39848
100000,26,49804.0,33774,168.87,50196,49804
2,27,1.0,1,0.01,1,1
3,27,1.0,2,0.01,2,1
100,27,48.0,32,0.16,52,48
200,27,104.0,76,0.38,96,104
2000,27,956.0,746,3.73,1044,956
10000,27,4999.0,4068,20.34,5001,4999
20000,27,10001.0,9505,47.53,9999,10001
40000,27,19851.0,20150,100.75,20149,19851
60000,27,29812.0,28153,140.77,30188,29812
80000,27,39792.0,32952,164.76,40208,39792
100000,27,49835.0,38105,190.53,50165,49835
2,28,1.0,1,0.01,1,1
3,28,2.0,1,0.01,1,2
100,28,46.0,53,0.27,54,46
200,28,93.0,110,0.55,107,93
2000,28,1013.0,742,3.71,987,1013
10000,28,5004.0,3903,19.52,4996,5004
20000,28,9986.0,7024,35.12,10014,9986
40000,28,19747.0,12468,62.34,20253,19747
60000,28,29707.0,21143,105.72,30293,29707
80000,28,39707.0,26476,132.38,40293,39707
100000,28,49662.0,35811,179.06,50338,49662
2,29,1.0,1,0.01,1,1
3,29,2.0,1,0.01,1,2
100,29,51.0,18,0.09,49,51
200,29,100.0,53,0.27,100,100
2000,29,1003.0,625,3.13,997,1003
10000,29,5025.0,3429,17.15,4975,5025
20000,29,10091.0,6365,31.83,9909,10091
40000,29,19987.0,15580,77.9,20013,19987
60000,29,29855.0,22644,113.22,30145,29855
80000,29,39899.0,32881,164.41,40101,39899
100000,29,49723.0,40905,204.53,50277,49723
2,30,2.0,1,0.01,0,2
3,30,3.0,2,0.01,0,3
100,30,56.0,44,0.22,44,56
200,30,113.0,81,0.41,87,113
2000,30,997.0,962,4.81,1003,997
10000,30,5045.0,4901,24.51,4955,5045
20000,30,10043.0,8274,41.37,9957,10043
40000,30,19997.0,14132,70.66,20003,19997
60000,30,29897.0,24644,123.22,30103,29897
80000,30,39867.0,32085,160.43,40133,39867
100000,30,49804.0,38254,191.27,50196,49804
2,31,0.0,1,0.01,2,0
3,31,1.0,2,0.01,2,1
100,31,49.0,34,0.17,51,49
200,31,102.0,53,0.27,98,102
2000,31,994.0,847,4.24,1006,994
10000,31,5014.0,3834,19.17,4986,5014
20000,31,9956.0,6856,34.28,10044,9956
40000,31,19814.0,15234,76.17,20186,19814
60000,31,29715.0,24403,122.02,30285,29715
80000,31,39772.0,31713,158.57,40228,39772
100000,31,49900.0,35429,177.15,50100,49900
2,32,2.0,1,0.01,0,2
3,32,3.0,2,0.01,0,3
100,32,46.0,59,0.3,54,46
200,32,95.0,140,0.7,105,95
2000,32,994.0,1089,5.45,1006,994
10000,32,5059.0,2999,15.0,4941,5059
20000,32,10003.0,6571,32.86,9997,10003
40000,32,20068.0,15011,75.06,19932,20068
60000,32,30007.0,20994,104.97,29993,30007
80000,32,39984.0,25152,125.76,40016,39984
100000,32,49959.0,29129,145.65,50041,49959
2,33,0.0,1,0.01,2,0
3,33,0.0,2,0.01,3,0
100,33,51.0,39,0.2,49,51
200,33,98.0,93,0.47,102,98
2000,33,968.0,858,4.29,1032,968
10000,33,5008.0,4734,23.67,4992,5008
20000,33,9951.0,10096,50.48,10049,9951
40000,33,19900.0,20537,102.69,20100,19900
60000,33,29884.0,30625,153.13,30116,29884
80000,33,39802.0,36064,180.32,40198,39802
100000,33,49874.0,43022,215.11,50126,49874
2,34,1.0,1,0.01,1,1
3,34,1.0,2,0.01,2,1
100,34,49.0,51,0.26,51,49
200,34,109.0,139,0.7,91,109
2000,34,967.0,1035,5.18,1033,967
10000,34,4934.0,5565,27.83,5066,4934
20000,34,9884.0,12159,60.8,10116,9884
40000,34,19831.0,25598,127.99,20169,19831
60000,34,29853.0,30212,151.06,30147,29853
80000,34,39866.0,34449,172.25,40134,39866
100000,34,49760.0,45118,225.59,50240,49760
2,35,1.0,1,0.01,1,1
3,35,2.0,1,0.01,1,2
100,35,52.0,32,0.16,48,52
200,35,98.0,61,0.31,102,98
2000,35,989.0,686,3.43,1011,989
10000,35,4990.0,4291,21.46,5010,4990
20000,35,9951.0,8836,44.18,10049,9951
40000,35,19903.0,20993,104.97,20097,19903
60000,35,29840.0,31374,156.87,30160,29840
80000,35,39749.0,36287,181.44,40251,39749
100000,35,49790.0,39520,197.6,50210,49790
2,36,0.0,1,0.01,2,0
3,36,1.0,2,0.01,2,1
100,36,52.0,69,0.35,48,52
200,36,107.0,125,0.63,93,107
2000,36,1016.0,1156,5.78,984,1016
10000,36,5012.0,5750,28.75,4988,5012
20000,36,10049.0,9172,45.86,9951,10049
40000,36,20056.0,18904,94.52,19944,20056
60000,36,30098.0,29545,147.73,29902,30098
80000,36,40054.0,38609,193.05,39946,40054
100000,36,49924.0,48583,242.92,50076,49924
2,37,2.0,1,0.01,0,2
3,37,2.0,2,0.01,1,2
100,37,48.0,69,0.35,52,48
200,37,106.0,119,0.6,94,106
2000,37,973.0,1149,5.75,1027,973
10000,37,4973.0,5848,29.24,5027,4973
20000,37,9925.0,11534,57.67,10075,9925
40000,37,19892.0,20325,101.63,20108,19892
60000,37,29796.0,28288,141.44,30204,29796
80000,37,39692.0,33990,169.95,40308,39692
100000,37,49582.0,42632,213.16,50418,49582
2,38,0.0,1,0.01,2,0
3,38,0.0,2,0.01,3,0
100,38,59.0,50,0.25,41,59
200,38,103.0,95,0.48,97,103
2000,38,1000.0,901,4.51,1000,1000
10000,38,4927.0,3389,16.95,5073,4927
20000,38,9943.0,9390,46.95,10057,9943
40000,38,19868.0,15253,76.27,20132,19868
60000,38,29787.0,24499,122.5,30213,29787
80000,38,39734.0,29860,149.3,40266,39734
100000,38,49744.0,35423,177.12,50256,49744
2,39,2.0,1,0.01,0,2
3,39,3.0,2,0.01,0,3
100,39,54.0,41,0.21,46,54
200,39,103.0,94,0.47,97,103
2000,39,1004.0,868,4.34,996,1004
10000,39,5011.0,4041,20.21,4989,5011
20000,39,10067.0,7942,39.71,9933,10067
40000,39,20042.0,13840,69.2,19958,20042
60000,39,29918.0,23432,117.16,30082,29918
80000,39,39928.0,28398,141.99,40072,39928
100000,39,49858.0,36113,180.57,50142,49858
2,40,2.0,1,0.01,0,2
3,40,2.0,2,0.01,1,2
100,40,60.0,36,0.18,40,60
200,40,118.0,87,0.44,82,118
2000,40,1010.0,954,4.77,990,1010
10000,40,5045.0,4405,22.03,4955,5045
20000,40,10020.0,9640,48.2,9980,10020
40000,40,19991.0,18089,90.45,20009,19991
60000,40,30071.0,24375,121.88,29929,30071
80000,40,39930.0,33183,165.92,40070,39930
100000,40,49831.0,41998,209.99,50169,49831
2,41,2.0,1,0.01,0,2
3,41,2.0,2,0.01,1,2
100,41,52.0,50,0.25,48,52
200,41,99.0,81,0.41,101,99
2000,41,984.0,684,3.42,1016,984
10000,41,4975.0,5878,29.39,5025,4975
20000,41,9920.0,11407,57.04,10080,9920
40000,41,19859.0,18666,93.33,20141,19859
60000,41,29912.0,26556,132.78,30088,29912
80000,41,39883.0,30776,153.88,40117,39883
100000,41,49982.0,34152,170.76,50018,49982
2,42,1.0,1,0.01,1,1
3,42,2.0,2,0.01,1,2
100,42,56.0,58,0.29,44,56
200,42,112.0,116,0.58,88,112
2000,42,1014.0,814,4.07,986,1014
10000,42,5049.0,4049,20.25,4951,5049
20000,42,9968.0,8125,40.63,10032,9968
40000,42,19956.0,12610,63.05,20044,19956
60000,42,30014.0,23724,118.62,29986,30014
80000,42,40050.0,34607,173.04,39950,40050
100000,42,50124.0,41958,209.79,49876,50124
2,43,1.0,1,0.01,1,1
3,43,1.0,1,0.01,2,1
100,43,49.0,45,0.23,51,49
200,43,96.0,88,0.44,104,96
2000,43,1000.0,864,4.32,1000,1000
10000,43,4993.0,5629,28.15,5007,4993
20000,43,9977.0,10991,54.96,10023,9977
40000,43,19881.0,20736,103.68,20119,19881
60000,43,29781.0,29553,147.77,30219,29781
80000,43,39523.0,37202,186.01,40477,39523
100000,43,49463.0,48414,242.07,50537,49463
2,44,1.0,1,0.01,1,1
3,44,1.0,2,0.01,2,1
100,44,52.0,41,0.21,48,52
200,44,113.0,104,0.52,87,113
2000,44,1030.0,826,4.13,970,1030
10000,44,5015.0,4470,22.35,4985,5015
20000,44,10043.0,9504,47.52,9957,10043
40000,44,19949.0,20542,102.71,20051,19949
60000,44,29925.0,32766,163.83,30075,29925
80000,44,39894.0,38866,194.33,40106,39894
100000,44,49839.0,49190,245.95,50161,49839
2,45,0.0,1,0.01,2,0
3,45,0.0,2,0.01,3,0
100,45,52.0,45,0.23,48,52
200,45,107.0,89,0.45,93,107
2000,45,1024.0,994,4.97,976,1024
10000,45,4989.0,5994,29.97,5011,4989
20000,45,9930.0,9668,48.34,10070,9930
40000,45,19924.0,19193,95.97,20076,19924
60000,45,29946.0,28259,141.3,30054,29946
80000,45,39976.0,37925,189.63,40024,39976
100000,45,49994.0,43024,215.12,50006,49994
2,46,0.0,1,0.01,2,0
3,46,1.0,2,0.01,2,1
100,46,35.0,61,0.31,65,35
200,46,91.0,142,0.71,109,91
2000,46,1010.0,1298,6.49,990,1010
10000,46,4975.0,4475,22.38,5025,4975
20000,46,10011.0,6662,33.31,9989,10011
40000,46,19927.0,12657,63.29,20073,19927
60000,46,29770.0,19459,97.3,30230,29770
80000,46,39690.0,28013,140.07,40310,39690
100000,46,49599.0,40740,203.7,50401,49599
2,47,2.0,1,0.01,0,2
3,47,3.0,2,0.01,0,3
100,47,60.0,44,0.22,40,60
200,47,116.0,91,0.46,84,116
2000,47,1014.0,823,4.12,986,1014
10000,47,5046.0,4815,24.08,4954,5046
20000,47,10018.0,9740,48.7,9982,10018
40000,47,20035.0,17325,86.63,19965,20035
60000,47,29991.0,22752,113.76,30009,29991
80000,47,39849.0,28558,142.79,40151,39849
100000,47,49792.0,33455,167.28,50208,49792
2,48,2.0,1,0.01,0,2
3,48,2.0,2,0.01,1,2
100,48,44.0,46,0.23,56,44
200,48,99.0,97,0.49,101,99
2000,48,974.0,1123,5.62,1026,974
10000,48,4934.0,5700,28.5,5066,4934
20000,48,9902.0,10737,53.69,10098,9902
40000,48,19978.0,16416,82.08,20022,19978
60000,48,29874.0,24139,120.7,30126,29874
80000,48,39828.0,31151,155.76,40172,39828
100000,48,49825.0,37925,189.63,50175,49825
2,49,1.0,1,0.01,1,1
3,49,2.0,2,0.01,1,2
100,49,52.0,47,0.24,48,52
200,49,111.0,99,0.5,89,111
2000,49,990.0,899,4.5,1010,990
10000,49,4998.0,4700,23.5,5002,4998
20000,49,10011.0,7927,39.64,9989,10011
40000,49,20032.0,16583,82.92,19968,20032
60000,49,29911.0,25888,129.44,30089,29911
80000,49,40021.0,29064,145.32,39979,40021
100000,49,50037.0,37315,186.58,49963,50037
2,50,2.0,1,0.01,0,2
3,50,2.0,2,0.01,1,2
100,50,60.0,43,0.22,40,60
200,50,109.0,77,0.39,91,109
2000,50,1004.0,1047,5.24,996,1004
10000,50,4973.0,4177,20.89,5027,4973
20000,50,10061.0,8339,41.7,9939,10061
40000,50,19991.0,13680,68.4,20009,19991
60000,50,30157.0,16172,80.86,29843,30157
80000,50,40059.0,20688,103.44,39941,40059
100000,50,50013.0,24241,121.21,49987,50013
2,51,1.0,1,0.01,1,1
3,51,1.0,1,0.01,2,1
100,51,52.0,40,0.2,48,52
200,51,104.0,75,0.38,96,104
2000,51,1003.0,1055,5.28,997,1003
10000,51,4962.0,5905,29.53,5038,4962
20000,51,9912.0,10282,51.41,10088,9912
40000,51,19790.0,20598,102.99,20210,19790
60000,51,29720.0,31532,157.66,30280,29720
80000,51,39571.0,42471,212.36,40429,39571
100000,51,49492.0,54213,271.07,50508,49492
2,52,1.0,1,0.01,1,1
3,52,1.0,2,0.01,2,1
100,52,45.0,45,0.23,55,45
200,52,96.0,67,0.34,104,96
2000,52,988.0,707,3.54,1012,988
10000,52,5052.0,3983,19.92,4948,5052
20000,52,9993.0,8309,41.55,10007,9993
40000,52,19931.0,17273,86.37,20069,19931
60000,52,29814.0,22802,114.01,30186,29814
80000,52,39919.0,28650,143.25,40081,39919
100000,52,49997.0,34467,172.34,50003,49997
2,53,1.0,1,0.01,1,1
3,53,2.0,2,0.01,1,2
100,53,55.0,67,0.34,45,55
200,53,108.0,133,0.67,92,108
2000,53,1006.0,1191,5.96,994,1006
10000,53,4990.0,6161,30.81,5010,4990
20000,53,9937.0,10630,53.15,10063,9937
40000,53,19767.0,20300,101.5,20233,19767
60000,53,29792.0,23007,115.04,30208,29792
80000,53,39832.0,32274,161.37,40168,39832
100000,53,49778.0,36133,180.67,50222,49778
2,54,2.0,1,0.01,0,2
3,54,2.0,2,0.01,1,2
100,54,58.0,43,0.22,42,58
200,54,97.0,86,0.43,103,97
2000,54,998.0,1132,5.66,1002,998
10000,54,5017.0,5837,29.19,4983,5017
20000,54,9980.0,11553,57.77,10020,9980
40000,54,20085.0,23770,118.85,19915,20085
60000,54,30023.0,36963,184.82,29977,30023
80000,54,39904.0,47828,239.14,40096,39904
100000,54,49947.0,55563,277.82,50053,49947
2,55,0.0,1,0.01,2,0
3,55,1.0,2,0.01,2,1
100,55,46.0,50,0.25,54,46
200,55,92.0,98,0.49,108,92
2000,55,941.0,1334,6.67,1059,941
10000,55,4979.0,3287,16.44,5021,4979
20000,55,9921.0,8985,44.93,10079,9921
40000,55,19806.0,17602,88.01,20194,19806
60000,55,29870.0,20906,104.53,30130,29870
80000,55,39960.0,24321,121.61,40040,39960
100000,55,49896.0,26550,132.75,50104,49896
2,56,1.0,1,0.01,1,1
3,56,2.0,1,0.01,1,2
100,56,47.0,55,0.28,53,47
200,56,93.0,110,0.55,107,93
2000,56,1007.0,916,4.58,993,1007
10000,56,4947.0,5601,28.01,5053,4947
20000,56,9921.0,8834,44.17,10079,9921
40000,56,19912.0,13489,67.45,20088,19912
60000,56,29916.0,20501,102.51,30084,29916
80000,56,39849.0,27758,138.79,40151,39849
100000,56,49696.0,35632,178.16,50304,49696
2,57,1.0,1,0.01,1,1
3,57,1.0,2,0.01,2,1
100,57,49.0,56,0.28,51,49
200,57,98.0,129,0.65,102,98
2000,57,978.0,1081,5.41,1022,978
10000,57,4974.0,5458,27.29,5026,4974
20000,57,9994.0,8052,40.26,10006,9994
40000,57,19908.0,18106,90.53,20092,19908
60000,57,29999.0,27338,136.69,30001,29999
80000,57,39982.0,34116,170.58,40018,39982
100000,57,49946.0,40554,202.77,50054,49946
2,58,0.0,1,0.01,2,0
3,58,0.0,2,0.01,3,0
100,58,51.0,53,0.27,49,51
200,58,98.0,126,0.63,102,98
2000,58,990.0,1103,5.52,1010,990
10000,58,4913.0,5731,28.66,5087,4913
20000,58,9892.0,10988,54.94,10108,9892
40000,58,19946.0,15537,77.69,20054,19946
60000,58,29782.0,23269,116.35,30218,29782
80000,58,39785.0,26416,132.08,40215,39785
100000,58,49693.0,32545,162.73,50307,49693
2,59,0.0,1,0.01,2,0
3,59,1.0,2,0.01,2,1
100,59,50.0,42,0.21,50,50
200,59,94.0,76,0.38,106,94
2000,59,1021.0,1023,5.12,979,1021
10000,59,5032.0,4080,20.4,4968,5032
20000,59,10102.0,9225,46.13,9898,10102
40000,59,19987.0,16866,84.33,20013,19987
60000,59,30086.0,23213,116.07,29914,30086
80000,59,40004.0,26277,131.39,39996,40004
100000,59,49996.0,34682,173.41,50004,49996
2,60,1.0,1,0.01,1,1
3,60,2.0,2,0.01,1,2
100,60,50.0,59,0.3,50,50
200,60,103.0,92,0.46,97,103
2000,60,1015.0,1230,6.15,985,1015
10000,60,4958.0,4550,22.75,5042,4958
20000,60,9958.0,9884,49.42,10042,9958
40000,60,19891.0,22832,114.16,20109,19891
60000,60,29873.0,32569,162.85,30127,29873
80000,60,39914.0,38357,191.79,40086,39914
100000,60,49903.0,45408,227.04,50097,49903
2,61,1.0,1,0.01,1,1
3,61,1.0,2,0.01,2,1
100,61,45.0,53,0.27,55,45
200,61,103.0,64,0.32,97,103
2000,61,1024.0,960,4.8,976,1024
10000,61,4984.0,4781,23.91,5016,4984
20000,61,9882.0,11279,56.4,10118,9882
40000,61,19796.0,21270,106.35,20204,19796
60000,61,29776.0,28342,141.71,30224,29776
80000,61,39700.0,40667,203.34,40300,39700
100000,61,49848.0,48271,241.36,50152,49848
2,62,0.0,1,0.01,2,0
3,62,1.0,2,0.01,2,1
100,62,50.0,61,0.31,50,50
200,62,98.0,130,0.65,102,98
2000,62,987.0,768,3.84,1013,987
10000,62,4977.0,3866,19.33,5023,4977
20000,62,9955.0,9282,46.41,10045,9955
40000,62,19947.0,19843,99.22,20053,19947
60000,62,29860.0,27878,139.39,30140,29860
80000,62,39829.0,37439,187.2,40171,39829
100000,62,49707.0,50452,252.26,50293,49707
2,63,1.0,1,0.01,1,1
3,63,2.0,2,0.01,1,2
100,63,56.0,44,0.22,44,56
200,63,99.0,84,0.42,101,99
2000,63,1004.0,938,4.69,996,1004
10000,63,4999.0,4220,21.1,5001,4999
20000,63,9912.0,8338,41.69,10088,9912
40000,63,19927.0,14441,72.21,20073,19927
60000,63,29830.0,20699,103.5,30170,29830
80000,63,39692.0,26079,130.4,40308,39692
100000,63,49633.0,32616,163.08,50367,49633
2,64,0.0,1,0.01,2,0
3,64,1.0,2,0.01,2,1
100,64,39.0,43,0.22,61,39
200,64,96.0,82,0.41,104,96
2000,64,1034.0,1212,6.06,966,1034
10000,64,5003.0,5285,26.43,4997,5003
20000,64,10030.0,11043,55.22,9970,10030
40000,64,20032.0,21343,106.72,19968,20032
60000,64,30061.0,29438,147.19,29939,30061
80000,64,40032.0,36023,180.12,39968,40032
100000,64,50085.0,43703,218.52,49915,50085
2,65,1.0,1,0.01,1,1
3,65,1.0,1,0.01,2,1
100,65,49.0,64,0.32,51,49
200,65,93.0,115,0.58,107,93
2000,65,983.0,1057,5.29,1017,983
10000,65,4975.0,5106,25.53,5025,4975
20000,65,9898.0,8780,43.9,10102,9898
40000,65,19875.0,14107,70.54,20125,19875
60000,65,29932.0,17965,89.83,30068,29932
80000,65,39935.0,25266,126.33,40065,39935
100000,65,49874.0,31169,155.85,50126,49874
2,66,1.0,1,0.01,1,1
3,66,2.0,1,0.01,1,2
100,66,49.0,33,0.17,51,49
200,66,101.0,94,0.47,99,101
2000,66,1022.0,1001,5.01,978,1022
10000,66,5042.0,5666,28.33,4958,5042
20000,66,9948.0,12545,62.73,10052,9948
40000,66,19745.0,23635,118.18,20255,19745
60000,66,29735.0,27745,138.73,30265,29735
80000,66,39701.0,31367,156.84,40299,39701
100000,66,49740.0,34512,172.56,50260,49740
2,67,0.0,1,0.01,2,0
3,67,1.0,2,0.01,2,1
100,67,42.0,60,0.3,58,42
200,67,93.0,79,0.4,107,93
2000,67,966.0,740,3.7,1034,966
10000,67,4901.0,3478,17.39,5099,4901
20000,67,9833.0,7812,39.06,10167,9833
40000,67,19797.0,15270,76.35,20203,19797
60000,67,29733.0,16898,84.49,30267,29733
80000,67,39810.0,18943,94.72,40190,39810
100000,67,49846.0,25808,129.04,50154,49846
2,68,1.0,1,0.01,1,1
3,68,1.0,1,0.01,2,1
100,68,51.0,56,0.28,49,51
200,68,91.0,109,0.55,109,91
2000,68,1010.0,1205,6.03,990,1010
10000,68,4965.0,4806,24.03,5035,4965
20000,68,9942.0,8564,42.82,10058,9942
40000,68,19834.0,19278,96.39,20166,19834
60000,68,29753.0,26991,134.96,30247,29753
80000,68,39638.0,33928,169.64,40362,39638
100000,68,49473.0,44241,221.21,50527,49473
2,69,1.0,1,0.01,1,1
3,69,1.0,2,0.01,2,1
100,69,43.0,53,0.27,57,43
200,69,86.0,88,0.44,114,86
2000,69,949.0,1070,5.35,1051,949
10000,69,4947.0,3590,17.95,5053,4947
20000,69,9977.0,7022,35.11,10023,9977
40000,69,19854.0,13808,69.04,20146,19854
60000,69,29785.0,19200,96.0,30215,29785
80000,69,39828.0,21392,106.96,40172,39828
100000,69,49788.0,23365,116.83,50212,49788
2,70,1.0,1,0.01,1,1
3,70,1.0,1,0.01,2,1
100,70,46.0,34,0.17,54,46
200,70,100.0,54,0.27,100,100
2000,70,1012.0,681,3.41,988,1012
10000,70,5069.0,4031,20.16,4931,5069
20000,70,10036.0,9602,48.01,9964,10036
40000,70,19955.0,16219,81.1,20045,19955
60000,70,29918.0,25214,126.07,30082,29918
80000,70,39843.0,30237,151.19,40157,39843
100000,70,49845.0,35391,176.96,50155,49845
2,71,1.0,1,0.01,1,1
3,71,1.0,2,0.01,2,1
100,71,49.0,56,0.28,51,49
200,71,98.0,118,0.59,102,98
2000,71,980.0,833,4.17,1020,980
10000,71,4955.0,4880,24.4,5045,4955
20000,71,9909.0,9314,46.57,10091,9909
40000,71,19831.0,16201,81.01,20169,19831
60000,71,29749.0,23344,116.72,30251,29749
80000,71,39631.0,29667,148.34,40369,39631
100000,71,49758.0,30739,153.7,50242,49758
2,72,0.0,1,0.01,2,0
3,72,1.0,2,0.01,2,1
100,72,46.0,58,0.29,54,46
200,72,95.0,109,0.55,105,95
2000,72,974.0,1137,5.69,1026,974
10000,72,4930.0,4558,22.79,5070,4930
20000,72,9827.0,7452,37.26,10173,9827
40000,72,19781.0,14407,72.04,20219,19781
60000,72,29701.0,23699,118.5,30299,29701
80000,72,39538.0,30564,152.82,40462,39538
100000,72,49501.0,39771,198.86,50499,49501
2,73,1.0,1,0.01,1,1
3,73,2.0,2,0.01,1,2
100,73,54.0,38,0.19,46,54
200,73,98.0,75,0.38,102,98
2000,73,971.0,937,4.69,1029,971
10000,73,4938.0,3163,15.82,5062,4938
20000,73,9882.0,6093,30.47,10118,9882
40000,73,19810.0,12554,62.77,20190,19810
60000,73,29754.0,21203,106.02,30246,29754
80000,73,39747.0,25959,129.8,40253,39747
100000,73,49787.0,35434,177.17,50213,49787
2,74,1.0,1,0.01,1,1
3,74,2.0,2,0.01,1,2
100,74,52.0,83,0.42,48,52
200,74,102.0,159,0.8,98,102
2000,74,994.0,1046,5.23,1006,994
10000,74,5025.0,4644,23.22,4975,5025
20000,74,9967.0,8795,43.98,10033,9967
40000,74,19920.0,14091,70.46,20080,19920
60000,74,29917.0,19107,95.54,30083,29917
80000,74,39884.0,23059,115.3,40116,39884
100000,74,49838.0,26741,133.71,50162,49838
2,75,1.0,1,0.01,1,1
3,75,2.0,1,0.01,1,2
100,75,62.0,32,0.16,38,62
200,75,115.0,67,0.34,85,115
2000,75,995.0,1055,5.28,1005,995
10000,75,4925.0,4705,23.53,5075,4925
20000,75,9904.0,10944,54.72,10096,9904
40000,75,19929.0,19362,96.81,20071,19929
60000,75,29875.0,27288,136.44,30125,29875
80000,75,39804.0,32039,160.2,40196,39804
100000,75,49838.0,40099,200.5,50162,49838
2,76,1.0,1,0.01,1,1
3,76,1.0,2,0.01,2,1
100,76,51.0,44,0.22,49,51
200,76,104.0,90,0.45,96,104
2000,76,1016.0,1151,5.76,984,1016
10000,76,4996.0,5466,27.33,5004,4996
20000,76,9939.0,12196,60.98,10061,9939
40000,76,19817.0,19824,99.12,20183,19817
60000,76,29718.0,25373,126.87,30282,29718
80000,76,39811.0,27139,135.7,40189,39811
100000,76,49752.0,39116,195.58,50248,49752
2,77,1.0,1,0.01,1,1
3,77,2.0,2,0.01,1,2
100,77,58.0,48,0.24,42,58
200,77,107.0,81,0.41,93,107
2000,77,1046.0,717,3.59,954,1046
10000,77,5065.0,3444,17.22,4935,5065
20000,77,10070.0,6526,32.63,9930,10070
40000,77,19874.0,14533,72.67,20126,19874
60000,77,29668.0,22930,114.65,30332,29668
80000,77,39633.0,31806,159.03,40367,39633
100000,77,49683.0,38861,194.31,50317,49683
2,78,1.0,1,0.01,1,1
3,78,1.0,2,0.01,2,1
100,78,57.0,54,0.27,43,57
200,78,107.0,104,0.52,93,107
2000,78,993.0,1028,5.14,1007,993
10000,78,4988.0,5112,25.56,5012,4988
20000,78,9958.0,11315,56.58,10042,9958
40000,78,19986.0,20437,102.19,20014,19986
60000,78,29945.0,29227,146.14,30055,29945
80000,78,40077.0,33091,165.46,39923,40077
100000,78,50128.0,38359,191.8,49872,50128
2,79,0.0,1,0.01,2,0
3,79,1.0,2,0.01,2,1
100,79,57.0,59,0.3,43,57
200,79,110.0,141,0.71,90,110
2000,79,1033.0,1323,6.62,967,1033
10000,79,5024.0,5889,29.45,4976,5024
20000,79,10063.0,10325,51.63,9937,10063
40000,79,19965.0,18447,92.24,20035,19965
60000,79,29930.0,24682,123.41,30070,29930
80000,79,39945.0,31840,159.2,40055,39945
100000,79,49923.0,44041,220.21,50077,49923
2,80,2.0,1,0.01,0,2
3,80,3.0,2,0.01,0,3
100,80,57.0,59,0.3,43,57
200,80,107.0,120,0.6,93,107
2000,80,1007.0,899,4.5,993,1007
10000,80,5055.0,5078,25.39,4945,5055
20000,80,10071.0,10424,52.12,9929,10071
40000,80,19989.0,18916,94.58,20011,19989
60000,80,29952.0,26059,130.3,30048,29952
80000,80,39830.0,36666,183.33,40170,39830
100000,80,49836.0,45595,227.98,50164,49836
2,81,1.0,1,0.01,1,1
3,81,1.0,1,0.01,2,1
100,81,44.0,43,0.22,56,44
200,81,90.0,67,0.34,110,90
2000,81,967.0,946,4.73,1033,967
10000,81,4991.0,4705,23.53,5009,4991
20000,81,10001.0,8868,44.34,9999,10001
40000,81,19885.0,19811,99.06,20115,19885
60000,81,29880.0,24684,123.42,30120,29880
80000,81,39805.0,32273,161.37,40195,39805
100000,81,49819.0,36058,180.29,50181,49819
2,82,1.0,1,0.01,1,1
3,82,2.0,1,0.01,1,2
100,82,53.0,51,0.26,47,53
200,82,108.0,96,0.48,92,108
2000,82,1010.0,1122,5.61,990,1010
10000,82,5031.0,6259,31.3,4969,5031
20000,82,9993.0,10205,51.03,10007,9993
40000,82,19918.0,17795,88.98,20082,19918
60000,82,29925.0,24507,122.54,30075,29925
80000,82,39923.0,29296,146.48,40077,39923
100000,82,49816.0,36751,183.76,50184,49816
2,83,2.0,1,0.01,0,2
3,83,2.0,2,0.01,1,2
100,83,49.0,39,0.2,51,49
200,83,107.0,73,0.37,93,107
2000,83,987.0,829,4.15,1013,987
10000,83,4965.0,3854,19.27,5035,4965
20000,83,9958.0,8564,42.82,10042,9958
40000,83,19862.0,19452,97.26,20138,19862
60000,83,29804.0,26134,130.67,30196,29804
80000,83,39815.0,32791,163.96,40185,39815
100000,83,49874.0,34157,170.79,50126,49874
2,84,0.0,1,0.01,2,0
3,84,1.0,2,0.01,2,1
100,84,51.0,44,0.22,49,51
200,84,109.0,84,0.42,91,109
2000,84,1012.0,1221,6.11,988,1012
10000,84,5008.0,4696,23.48,4992,5008
20000,84,9945.0,10537,52.69,10055,9945
40000,84,19928.0,18343,91.72,20072,19928
60000,84,29866.0,27890,139.45,30134,29866
80000,84,39848.0,37692,188.46,40152,39848
100000,84,49813.0,47842,239.21,50187,49813
2,85,0.0,1,0.01,2,0
3,85,0.0,2,0.01,3,0
100,85,46.0,43,0.22,54,46
200,85,96.0,69,0.35,104,96
2000,85,997.0,723,3.62,1003,997
10000,85,4964.0,5039,25.2,5036,4964
20000,85,9950.0,10157,50.79,10050,9950
40000,85,20001.0,17525,87.63,19999,20001
60000,85,30067.0,25265,126.33,29933,30067
80000,85,39986.0,32912,164.56,40014,39986
100000,85,50049.0,38155,190.78,49951,50049
2,86,0.0,1,0.01,2,0
3,86,0.0,2,0.01,3,0
100,86,54.0,55,0.28,46,54
200,86,100.0,110,0.55,100,100
2000,86,1025.0,729,3.65,975,1025
10000,86,5037.0,3312,16.56,4963,5037
20000,86,10012.0,7397,36.99,9988,10012
40000,86,19878.0,13699,68.5,20122,19878
60000,86,29850.0,26494,132.47,30150,29850
80000,86,39687.0,37098,185.49,40313,39687
100000,86,49528.0,41500,207.5,50472,49528
2,87,2.0,1,0.01,0,2
3,87,2.0,2,0.01,1,2
100,87,51.0,41,0.21,49,51
200,87,99.0,91,0.46,101,99
2000,87,932.0,797,3.99,1068,932
10000,87,4824.0,4647,23.24,5176,4824
20000,87,9815.0,9088,45.44,10185,9815
40000,87,19881.0,14292,71.46,20119,19881
60000,87,29807.0,19793,98.97,30193,29807
80000,87,39770.0,24011,120.06,40230,39770
100000,87,49750.0,27420,137.1,50250,49750
2,88,0.0,1,0.01,2,0
3,88,1.0,2,0.01,2,1
100,88,49.0,66,0.33,51,49
200,88,110.0,99,0.5,90,110
2000,88,1002.0,804,4.02,998,1002
10000,88,4916.0,4413,22.07,5084,4916
20000,88,9970.0,8577,42.89,10030,9970
40000,88,20002.0,18053,90.27,19998,20002
60000,88,29889.0,26084,130.42,30111,29889
80000,88,39778.0,30324,151.62,40222,39778
100000,88,49752.0,36468,182.34,50248,49752
2,89,1.0,1,0.01,1,1
3,89,2.0,1,0.01,1,2
100,89,52.0,32,0.16,48,52
200,89,113.0,58,0.29,87,113
2000,89,1013.0,980,4.9,987,1013
10000,89,5083.0,4732,23.66,4917,5083
20000,89,10071.0,9710,48.55,9929,10071
40000,89,20054.0,16858,84.29,19946,20054
60000,89,30055.0,22820,114.1,29945,30055
80000,89,40025.0,33594,167.97,39975,40025
100000,89,49946.0,38890,194.45,50054,49946
2,90,1.0,1,0.01,1,1
3,90,1.0,1,0.01,2,1
100,90,54.0,61,0.31,46,54
200,90,88.0,116,0.58,112,88
2000,90,977.0,1192,5.96,1023,977
10000,90,4922.0,5109,25.55,5078,4922
20000,90,9915.0,10824,54.12,10085,9915
40000,90,19949.0,16134,80.67,20051,19949
60000,90,29970.0,26423,132.12,30030,29970
80000,90,40009.0,35283,176.42,39991,40009
100000,90,49960.0,39509,197.55,50040,49960
2,91,2.0,1,0.01,0,2
3,91,3.0,2,0.01,0,3
100,91,53.0,32,0.16,47,53
200,91,103.0,70,0.35,97,103
2000,91,987.0,708,3.54,1013,987
10000,91,4969.0,4779,23.9,5031,4969
20000,91,9902.0,9351,46.76,10098,9902
40000,91,19734.0,16006,80.03,20266,19734
60000,91,29601.0,22100,110.5,30399,29601
80000,91,39546.0,28472,142.36,40454,39546
100000,91,49493.0,31610,158.05,50507,49493
2,92,1.0,1,0.01,1,1
3,92,2.0,2,0.01,1,2
100,92,39.0,35,0.18,61,39
200,92,87.0,112,0.56,113,87
2000,92,998.0,585,2.93,1002,998
10000,92,5012.0,3710,18.55,4988,5012
20000,92,10052.0,8387,41.94,9948,10052
40000,92,20105.0,16162,80.81,19895,20105
60000,92,30056.0,24013,120.07,29944,30056
80000,92,40040.0,32354,161.77,39960,40040
100000,92,49903.0,40778,203.89,50097,49903
2,93,1.0,1,0.01,1,1
3,93,2.0,1,0.01,1,2
100,93,49.0,44,0.22,51,49
200,93,94.0,87,0.44,106,94
2000,93,955.0,510,2.55,1045,955
10000,93,4986.0,3419,17.1,5014,4986
20000,93,10014.0,8338,41.69,9986,10014
40000,93,19953.0,15752,78.76,20047,19953
60000,93,29954.0,22996,114.98,30046,29954
80000,93,40010.0,30042,150.21,39990,40010
100000,93,49957.0,35206,176.03,50043,49957
2,94,0.0,1,0.01,2,0
3,94,1.0,2,0.01,2,1
100,94,48.0,33,0.17,52,48
200,94,91.0,74,0.37,109,91
2000,94,1019.0,923,4.62,981,1019
10000,94,5057.0,4216,21.08,4943,5057
20000,94,10021.0,8729,43.65,9979,10021
40000,94,19961.0,14225,71.13,20039,19961
60000,94,29902.0,23243,116.22,30098,29902
80000,94,39908.0,31560,157.8,40092,39908
100000,94,49787.0,39616,198.08,50213,49787
2,95,2.0,1,0.01,0,2
3,95,3.0,2,0.01,0,3
100,95,68.0,51,0.26,32,68
200,95,114.0,108,0.54,86,114
2000,95,1021.0,871,4.36,979,1021
10000,95,4833.0,4901,24.51,5167,4833
20000,95,9786.0,11097,55.49,10214,9786
40000,95,19544.0,20931,104.66,20456,19544
60000,95,29680.0,23680,118.4,30320,29680
80000,95,39654.0,27001,135.01,40346,39654
100000,95,49677.0,39781,198.91,50323,49677
2,96,1.0,1,0.01,1,1
3,96,2.0,2,0.01,1,2
100,96,40.0,65,0.33,60,40
200,96,89.0,150,0.75,111,89
2000,96,993.0,1316,6.58,1007,993
10000,96,4990.0,5608,28.04,5010,4990
20000,96,9981.0,9671,48.36,10019,9981
40000,96,19939.0,19048,95.24,20061,19939
60000,96,29874.0,30288,151.44,30126,29874
80000,96,39826.0,36699,183.5,40174,39826
100000,96,49686.0,44129,220.65,50314,49686
2,97,0.0,1,0.01,2,0
3,97,0.0,2,0.01,3,0
100,97,54.0,33,0.17,46,54
200,97,100.0,83,0.42,100,100
2000,97,1017.0,924,4.62,983,1017
10000,97,4982.0,5448,27.24,5018,4982
20000,97,9933.0,10791,53.96,10067,9933
40000,97,19843.0,18779,93.9,20157,19843
60000,97,29848.0,28243,141.22,30152,29848
80000,97,39791.0,40158,200.79,40209,39791
100000,97,49694.0,51513,257.57,50306,49694
2,98,1.0,1,0.01,1,1
3,98,1.0,1,0.01,2,1
100,98,53.0,31,0.16,47,53
200,98,101.0,67,0.34,99,101
2000,98,1000.0,604,3.02,1000,1000
10000,98,4949.0,3821,19.11,5051,4949
20000,98,9952.0,6826,34.13,10048,9952
40000,98,19964.0,10676,53.38,20036,19964
60000,98,29832.0,16213,81.07,30168,29832
80000,98,39965.0,18274,91.37,40035,39965
100000,98,50019.0,22010,110.05,49981,50019
2,99,1.0,1,0.01,1,1
3,99,2.0,2,0.01,1,2
100,99,51.0,52,0.26,49,51
200,99,98.0,97,0.49,102,98
2000,99,1006.0,1023,5.12,994,1006
10000,99,5031.0,4038,20.19,4969,5031
20000,99,9928.0,8344,41.72,10072,9928
40000,99,19762.0,16486,82.43,20238,19762
60000,99,29619.0,27783,138.92,30381,29619
80000,99,39715.0,33308,166.54,40285,39715
100000,99,49744.0,34209,171.05,50256,49744
2,100,1.0,1,0.01,1,1
3,100,2.0,2,0.01,1,2
100,100,50.0,44,0.22,50,50
200,100,95.0,83,0.42,105,95
2000,100,993.0,1149,5.75,1007,993
10000,100,4965.0,5109,25.55,5035,4965
20000,100,9930.0,7741,38.71,10070,9930
40000,100,19929.0,17891,89.46,20071,19929
60000,100,29858.0,22436,112.18,30142,29858
80000,100,39980.0,28927,144.64,40020,39980
100000,100,49881.0,35662,178.31,50119,49881
