Timestep,Iteration,Total Reward,Suboptimal Arms,Total Regret,Zeros Count,Ones Count
2,1,2.011800887827553,1,0.1,0,2
3,1,2.458869541178248,1,0.1,1,2
100,1,81.05227873637556,50,5.0,54,46
200,1,164.20418114006148,95,9.5,105,95
2000,1,1749.2683731965394,525,52.5,985,1015
10000,1,8918.191181765542,1075,107.5,4949,5051
20000,1,17906.974558087608,1295,129.5,9947,10053
40000,1,35800.714306584836,1687,168.7,19985,20015
60000,1,53729.51820901518,1817,181.7,30144,29856
80000,1,71794.46849077527,1875,187.5,39989,40011
100000,1,89824.99815651507,1899,189.9,49987,50013
2,2,1.7585283965179233,1,0.1,1,1
3,2,2.830341008233229,1,0.1,1,2
100,2,83.10568867813218,50,5.0,49,51
200,2,175.16415377355466,95,9.5,94,106
2000,2,1726.962117679313,723,72.3,1006,994
10000,2,8831.935951047582,1474,147.4,5006,4994
20000,2,17774.064644757364,1919,191.9,9988,10012
40000,2,35736.530220198256,2219,221.9,20028,19972
60000,2,53711.24283765941,2445,244.5,29976,30024
80000,2,71646.95006422451,2865,286.5,39996,40004
100000,2,89652.61745607927,2927,292.7,49997,50003
2,3,1.3179870575011736,1,0.1,1,1
3,3,2.2744982301884766,1,0.1,1,2
100,3,84.51900450467764,50,5.0,51,49
200,3,168.6528517036818,93,9.3,100,100
2000,3,1732.6784998874246,490,49.0,1008,992
10000,3,8882.072521142032,1107,110.7,4982,5018
20000,3,17886.25065648357,1295,129.5,9979,10021
40000,3,35737.029927521784,1610,161.0,20130,19870
60000,3,53722.10933323108,1867,186.7,30137,29863
80000,3,71749.43882707701,1960,196.0,40040,39960
100000,3,89805.69136457566,1978,197.8,49905,50095
2,4,2.0780984528727946,1,0.1,1,1
3,4,3.595118518706144,1,0.1,1,2
100,4,90.03045860167357,50,5.0,48,52
200,4,176.8434786987884,104,10.4,97,103
2000,4,1754.8724608153523,613,61.3,992,1008
10000,4,8923.447825094214,1115,111.5,4918,5082
20000,4,17902.692243219506,1778,177.8,9902,10098
40000,4,35810.27942970433,2106,210.6,19958,20042
60000,4,53841.06755810288,2219,221.9,29942,30058
80000,4,71801.5400366482,2431,243.1,39954,40046
100000,4,89844.92070638938,2456,245.6,49969,50031
2,5,1.7788788813436616,1,0.1,1,1
3,5,2.9791391118523647,1,0.1,1,2
100,5,83.81453109061064,50,5.0,54,46
200,5,169.86338142282236,107,10.7,104,96
2000,5,1749.3113395974756,530,53.0,993,1007
10000,5,8836.79573905688,1163,116.3,5065,4935
20000,5,17793.56436904398,1452,145.2,10085,9915
40000,5,35663.545566413086,1850,185.0,20195,19805
60000,5,53635.85965838053,2125,212.5,30164,29836
80000,5,71618.73517860846,2256,225.6,40192,39808
100000,5,89575.63592901894,2411,241.1,50310,49690
2,6,1.3322622261328823,1,0.1,2,0
3,6,2.2217276745044057,1,0.1,3,0
100,6,90.26133240811485,50,5.0,46,54
200,6,179.3447786150088,107,10.7,93,107
2000,6,1746.0704535999566,637,63.7,979,1021
10000,6,8876.945175209492,1308,130.8,4964,5036
20000,6,17851.720860478064,1896,189.6,9942,10058
40000,6,35842.85066170303,2272,227.2,19957,20043
60000,6,53839.61945315857,2365,236.5,29934,30066
80000,6,71834.5213098489,2504,250.4,39938,40062
100000,6,89821.45690065343,2564,256.4,49949,50051
2,7,0.7217660631305467,1,0.1,2,0
3,7,1.706835410714791,1,0.1,2,1
100,7,80.06349363010789,50,5.0,55,45
200,7,159.02488104688067,93,9.3,112,88
2000,7,1724.6263283846024,515,51.5,1040,960
10000,7,8882.902368267196,906,90.6,5049,4951
20000,7,17832.65402607691,1167,116.7,10076,9924
40000,7,35816.44072625025,1408,140.8,20056,19944
60000,7,53817.59817853883,1556,155.6,30035,29965
80000,7,71816.10816669451,1621,162.1,39956,40044
100000,7,89724.59047625169,1710,171.0,50031,49969
2,8,2.097818611913549,1,0.1,1,1
3,8,2.951719743893433,1,0.1,2,1
100,8,82.3766770077795,50,5.0,55,45
200,8,168.64791047788142,105,10.5,102,98
2000,8,1715.4536120783678,641,64.1,1046,954
10000,8,8874.415776306181,1320,132.0,5010,4990
20000,8,17826.947221666847,1614,161.4,10098,9902
40000,8,35801.769291211545,1880,188.0,20107,19893
60000,8,53789.579580076286,2002,200.2,30147,29853
80000,8,71786.8013304455,2150,215.0,40082,39918
100000,8,89750.72885036102,2278,227.8,50146,49854
2,9,1.848141660639329,1,0.1,0,2
3,9,3.173498535378558,1,0.1,0,3
100,9,78.6927659757158,50,5.0,59,41
200,9,162.08898081717706,93,9.3,116,84
2000,9,1766.492153117868,526,52.6,997,1003
10000,9,8896.357188354656,1205,120.5,5005,4995
20000,9,17876.93990862623,1424,142.4,9979,10021
40000,9,35867.73099613851,1693,169.3,20005,19995
60000,9,53889.20875190294,1817,181.7,29960,30040
80000,9,71877.90803517468,1995,199.5,39967,40033
100000,9,89806.91983138013,2111,211.1,50065,49935
2,10,1.6141012804667687,1,0.1,2,0
3,10,2.478508543741956,1,0.1,3,0
100,10,81.77954356933591,50,5.0,59,41
200,10,160.86305421194967,94,9.4,118,82
2000,10,1735.7803374030457,478,47.8,1007,993
10000,10,8911.918283594992,1044,104.4,4931,5069
20000,10,17836.74721024083,1518,151.8,9942,10058
40000,10,35837.585130588275,1684,168.4,19911,20089
60000,10,53755.03839884615,2081,208.1,30025,29975
80000,10,71782.57433662472,2207,220.7,40026,39974
100000,10,89760.0173545724,2262,226.2,50030,49970
2,11,1.8314580843391026,1,0.1,1,1
3,11,3.0933151198284317,1,0.1,1,2
100,11,87.94721186620662,50,5.0,47,53
200,11,173.03244085783427,103,10.3,93,107
2000,11,1747.6521565408655,667,66.7,977,1023
10000,11,8854.30823855104,1343,134.3,4994,5006
20000,11,17860.794589159115,1580,158.0,9926,10074
40000,11,35895.09852564004,1708,170.8,19848,20152
60000,11,53987.38025291711,1844,184.4,29697,30303
80000,11,71955.25629298766,1979,197.9,39704,40296
100000,11,89972.49537872444,2110,211.0,49572,50428
2,12,1.9020097563303884,1,0.1,1,1
3,12,2.07426387613835,1,0.1,2,1
100,12,79.80854750510352,50,5.0,60,40
200,12,167.33518194835446,93,9.3,105,95
2000,12,1760.1391995435174,378,37.8,1005,995
10000,12,8925.607636812078,885,88.5,4995,5005
20000,12,17911.62767250339,1501,150.1,9957,10043
40000,12,35902.31447558305,2044,204.4,19801,20199
60000,12,53829.69364050893,2241,224.1,29795,30205
80000,12,71857.69499542691,2325,232.5,39768,40232
100000,12,89883.87341108825,2384,238.4,49657,50343
2,13,1.4405382534308044,1,0.1,1,1
3,13,2.3918672331283823,1,0.1,1,2
100,13,87.0879438507809,50,5.0,45,55
200,13,165.29274021209835,93,9.3,100,100
2000,13,1755.6862143724202,378,37.8,998,1002
10000,13,8894.50707139043,1307,130.7,4982,5018
20000,13,17880.442163871256,1547,154.7,10010,9990
40000,13,35816.557813682695,1815,181.5,20120,19880
60000,13,53791.00256592498,1930,193.0,30074,29926
80000,13,71812.24159667578,2054,205.4,40028,39972
100000,13,89750.55590235184,2126,212.6,50149,49851
2,14,2.2471210053763406,1,0.1,0,2
3,14,2.616635591159426,1,0.1,1,2
100,14,85.16296788959274,50,5.0,52,48
200,14,171.3917844732056,93,9.3,102,98
2000,14,1759.1575638251984,474,47.4,988,1012
10000,14,8855.55980250649,1233,123.3,5031,4969
20000,14,17795.08690005717,1517,151.7,10067,9933
40000,14,35777.27510936855,2082,208.2,20066,19934
60000,14,53774.39360915945,2207,220.7,30075,29925
80000,14,71764.57249042414,2355,235.5,40042,39958
100000,14,89743.91293410887,2453,245.3,50117,49883
2,15,1.646525853480619,1,0.1,1,1
3,15,2.840869944043533,1,0.1,1,2
100,15,88.56215496038118,50,5.0,46,54
200,15,173.9050447374228,97,9.7,90,110
2000,15,1736.8058606184588,526,52.6,1013,987
10000,15,8886.161963482822,1007,100.7,5039,4961
20000,15,17843.106692418187,1183,118.3,10020,9980
40000,15,35790.80915540645,1391,139.1,20082,19918
60000,15,53771.80582979226,1558,155.8,30147,29853
80000,15,71742.43728830303,1732,173.2,40119,39881
100000,15,89703.07351814017,1871,187.1,50183,49817
2,16,2.2620614232569984,1,0.1,0,2
3,16,3.4775518106980257,1,0.1,0,3
100,16,85.13899600822316,50,5.0,46,54
200,16,174.48124309484317,93,9.3,91,109
2000,16,1761.7438873574472,475,47.5,972,1028
10000,16,8930.501733785528,1089,108.9,4933,5067
20000,16,17919.84444087622,1312,131.2,9918,10082
40000,16,35934.14712165596,1483,148.3,19808,20192
60000,16,53879.05679348329,1678,167.8,29909,30091
80000,16,71890.4505128265,1771,177.1,39955,40045
100000,16,89959.66250501393,1834,183.4,49771,50229
2,17,1.3937882769314756,1,0.1,2,0
3,17,2.464983810361948,1,0.1,2,1
100,17,81.79047453412369,50,5.0,56,44
200,17,168.04022708611433,101,10.1,109,91
2000,17,1753.8710022170965,475,47.5,1005,995
10000,17,8925.19974642683,1060,106.0,4941,5059
20000,17,17904.849315095325,1257,125.7,9931,10069
40000,17,35905.883916838124,1443,144.3,19936,20064
60000,17,53862.12813282417,1590,159.0,30026,29974
80000,17,71859.41953935867,1642,164.2,40024,39976
100000,17,89754.47655489526,1721,172.1,50148,49852
2,18,1.9200704759586,1,0.1,1,1
3,18,2.3533167694584765,1,0.1,2,1
100,18,85.07563051791755,50,5.0,50,50
200,18,165.7980819683821,97,9.7,107,93
2000,18,1744.6305817986502,483,48.3,1027,973
10000,18,8889.312277630943,980,98.0,5019,4981
20000,18,17829.713340563514,1488,148.8,10000,10000
40000,18,35811.51423389807,1715,171.5,20033,19967
60000,18,53735.826297472835,1883,188.3,30080,29920
80000,18,71743.619571421,1970,197.0,40118,39882
100000,18,89724.43446851494,2079,207.9,50119,49881
2,19,3.1022496117177747,1,0.1,0,2
3,19,4.235554095007718,1,0.1,0,3
100,19,84.88872603202442,50,5.0,48,52
200,19,170.01343060035498,103,10.3,92,108
2000,19,1746.0555812751445,501,50.1,991,1009
10000,19,8926.036007271181,924,92.4,4948,5052
20000,19,17878.914779293285,1119,111.9,9968,10032
40000,19,35894.37506593242,1428,142.8,19909,20091
60000,19,53830.77175681663,1692,169.2,29929,30071
80000,19,71817.21527718716,1773,177.3,39910,40090
100000,19,89791.34039807646,1807,180.7,49942,50058
2,20,2.2930344892425065,1,0.1,1,1
3,20,3.8525095462222088,1,0.1,1,2
100,20,81.75215416847169,50,5.0,56,44
200,20,166.56722708515738,104,10.4,109,91
2000,20,1723.6180225350026,704,70.4,1029,971
10000,20,8866.864311419284,1340,134.0,5013,4987
20000,20,17843.731716944752,1689,168.9,10025,9975
40000,20,35775.84708843485,1994,199.4,20081,19919
60000,20,53780.31542833134,2123,212.3,30042,29958
80000,20,71845.36668792041,2262,226.2,39913,40087
100000,20,89817.64066512832,2463,246.3,49897,50103
2,21,1.363949752779544,1,0.1,2,0
3,21,1.5914910442546488,1,0.1,3,0
100,21,81.5992779531895,50,5.0,51,49
200,21,167.22068239305784,93,9.3,103,97
2000,21,1756.0526238533819,424,42.4,1018,982
10000,21,8923.331997195517,910,91.0,4994,5006
20000,21,17919.958415330275,1158,115.8,9980,10020
40000,21,35862.944149579795,1357,135.7,20011,19989
60000,21,53894.14795132104,1481,148.1,29990,30010
80000,21,71885.61588530036,1582,158.2,39957,40043
100000,21,89846.92402389216,1718,171.8,49939,50061
2,22,1.8312152561567427,1,0.1,0,2
3,22,3.156623006551776,1,0.1,0,3
100,22,87.91255301659926,50,5.0,45,55
200,22,176.4449645704249,93,9.3,90,110
2000,22,1751.412189139814,615,61.5,1006,994
10000,22,8880.034352066355,1319,131.9,4975,5025
20000,22,17850.57861409176,1649,164.9,9938,10062
40000,22,35842.705976386285,2150,215.0,19802,20198
60000,22,53827.57261381919,2369,236.9,29798,30202
80000,22,71822.79851853532,2480,248.0,39755,40245
100000,22,89739.02073842633,2611,261.1,49793,50207
2,23,2.243769531009627,1,0.1,1,1
3,23,2.8192758554713784,1,0.1,2,1
100,23,80.26098399705525,50,5.0,54,46
200,23,160.02869213794526,95,9.5,109,91
2000,23,1760.7735100686946,418,41.8,1001,999
10000,23,8931.674482886712,1015,101.5,4956,5044
20000,23,17872.40037657907,1442,144.2,10033,9967
40000,23,35897.92182829718,1605,160.5,19945,20055
60000,23,53874.09888375547,1754,175.4,29947,30053
80000,23,71851.6443460222,1803,180.3,39942,40058
100000,23,89863.70600861221,1855,185.5,49922,50078
2,24,2.0704665563355684,1,0.1,0,2
3,24,2.696795037931339,1,0.1,1,2
100,24,87.5471414047817,50,5.0,49,51
200,24,179.29335895223906,107,10.7,92,108
2000,24,1744.6285597970223,763,76.3,948,1052
10000,24,8897.459172530904,1266,126.6,4932,5068
20000,24,17892.34345289043,1501,150.1,9884,10116
40000,24,35926.192959250286,1665,166.5,19745,20255
60000,24,53983.20019043424,1797,179.7,29679,30321
80000,24,71897.0636471389,1933,193.3,39815,40185
100000,24,89905.78244229301,2011,201.1,49837,50163
2,25,1.5069279911311058,1,0.1,1,1
3,25,2.6447708024713132,1,0.1,1,2
100,25,96.17370741063631,50,5.0,43,57
200,25,181.27823615205602,93,9.3,92,108
2000,25,1765.588997651988,620,62.0,961,1039
10000,25,8817.200973537618,1547,154.7,5012,4988
20000,25,17779.313562824085,1839,183.9,10058,9942
40000,25,35713.92121202088,2030,203.0,20128,19872
60000,25,53723.165547913886,2158,215.8,30128,29872
80000,25,71714.5280187855,2245,224.5,40172,39828
100000,25,89719.18035197424,2309,230.9,50148,49852
2,26,1.0740940555216651,1,0.1,2,0
3,26,2.265709705797586,1,0.1,2,1
100,26,87.18605266925245,50,5.0,47,53
200,26,177.74868593316071,93,9.3,88,112
2000,26,1748.091458925986,652,65.2,1008,992
10000,26,8866.590077462688,1676,167.6,4978,5022
20000,26,17836.211539346317,1958,195.8,9958,10042
40000,26,35856.67843636384,2394,239.4,19844,20156
60000,26,53854.33644455112,2526,252.6,29835,30165
80000,26,71826.0001831642,2706,270.6,39842,40158
100000,26,89745.9696508271,2889,288.9,49916,50084
2,27,1.2988540346573894,1,0.1,1,1
3,27,2.392535444953455,1,0.1,1,2
100,27,89.16882942446843,50,5.0,45,55
200,27,173.4378117443592,105,10.5,93,107
2000,27,1764.5375494876562,496,49.6,999,1001
10000,27,8882.13364219049,1428,142.8,5017,4983
20000,27,17820.69847329728,1723,172.3,10061,9939
40000,27,35798.76877914585,2045,204.5,19972,20028
60000,27,53847.37006819514,2161,216.1,29915,30085
80000,27,71862.58347171187,2212,221.2,39911,40089
100000,27,89781.67736951598,2404,240.4,49959,50041
2,28,2.6217558160051695,1,0.1,0,2
3,28,3.830398585457271,1,0.1,0,3
100,28,83.73236713376626,50,5.0,52,48
200,28,171.7029584553,102,10.2,98,102
2000,28,1756.966608957243,466,46.6,992,1008
10000,28,8908.611586448458,987,98.7,4975,5025
20000,28,17896.806163552534,1344,134.4,9943,10057
40000,28,35829.26303025011,1587,158.7,20078,19922
60000,28,53794.520501335835,1703,170.3,30055,29945
80000,28,71789.04323435007,1872,187.2,40000,40000
100000,28,89892.83836462093,1892,189.2,49843,50157
2,29,0.8686358779202481,1,0.1,1,1
3,29,2.282800342235756,1,0.1,1,2
100,29,89.24141615626581,50,5.0,48,52
200,29,174.96794357156693,96,9.6,89,111
2000,29,1743.0457822192232,551,55.1,1007,993
10000,29,8916.89704000336,1073,107.3,4968,5032
20000,29,17845.075038274055,1693,169.3,9937,10063
40000,29,35756.9642423571,2166,216.6,20024,19976
60000,29,53676.864154371935,2393,239.3,30107,29893
80000,29,71706.66371822139,2577,257.7,40027,39973
100000,29,89630.71439503969,2642,264.2,50120,49880
2,30,2.2498516692218145,1,0.1,1,1
3,30,3.293408548956381,1,0.1,1,2
100,30,85.086147298479,50,5.0,52,48
200,30,178.8783738605907,93,9.3,93,107
2000,30,1749.9887064377117,453,45.3,993,1007
10000,30,8883.980509261875,1078,107.8,4976,5024
20000,30,17888.716408711876,1285,128.5,9926,10074
40000,30,35825.12625617364,1541,154.1,19881,20119
60000,30,53839.73677562901,1725,172.5,29811,30189
80000,30,71812.4786733687,1900,190.0,39799,40201
100000,30,89787.64875115082,1986,198.6,49823,50177
2,31,1.1733589433595648,1,0.1,2,0
3,31,1.846657999583761,1,0.1,3,0
100,31,78.38816853209808,50,5.0,54,46
200,31,168.02513730606097,93,9.3,99,101
2000,31,1717.4686293060822,588,58.8,1052,948
10000,31,8858.423058128652,1178,117.8,5015,4985
20000,31,17872.29070706374,1445,144.5,9932,10068
40000,31,35820.010340977955,1697,169.7,20022,19978
60000,31,53725.64173042868,2129,212.9,30147,29853
80000,31,71723.56642269876,2280,228.0,40145,39855
100000,31,89686.49160250631,2363,236.3,50187,49813
2,32,1.3281198305511963,1,0.1,2,0
3,32,2.778171147729372,1,0.1,2,1
100,32,86.84608061493948,50,5.0,50,50
200,32,174.3066059801607,104,10.4,101,99
2000,32,1726.4581051247612,688,68.8,1009,991
10000,32,8854.82601766448,1400,140.0,4986,5014
20000,32,17787.52649374182,1826,182.6,10007,9993
40000,32,35810.48081144503,2070,207.0,19952,20048
60000,32,53750.59565055394,2166,216.6,29995,30005
80000,32,71661.11715095074,2320,232.0,40132,39868
100000,32,89627.16919980783,2356,235.6,50198,49802
2,33,2.350908816611394,1,0.1,0,2
3,33,3.3007008362539025,1,0.1,0,3
100,33,85.96896694486853,50,5.0,46,54
200,33,169.42148810454728,98,9.8,99,101
2000,33,1762.748502675751,707,70.7,943,1057
10000,33,8866.729792692897,1641,164.1,4922,5078
20000,33,17846.82331349098,1885,188.5,9919,10081
40000,33,35849.95826740907,2162,216.2,19871,20129
60000,33,53880.65556281776,2410,241.0,29794,30206
80000,33,71887.74298819454,2537,253.7,39705,40295
100000,33,89883.91931983182,2599,259.9,49712,50288
2,34,1.754551239075509,1,0.1,1,1
3,34,2.0476961082740965,1,0.1,2,1
100,34,84.12100807622402,50,5.0,43,57
200,34,166.2172846282042,93,9.3,94,106
2000,34,1764.131941191141,509,50.9,970,1030
10000,34,8865.499110908673,1351,135.1,5031,4969
20000,34,17760.979560516855,1761,176.1,10095,9905
40000,34,35786.98815053521,1994,199.4,20043,19957
60000,34,53875.59592121515,2138,213.8,29902,30098
80000,34,71899.29678229771,2387,238.7,39853,40147
100000,34,89869.75775587873,2511,251.1,49846,50154
2,35,1.8129499333946861,1,0.1,1,1
3,35,3.039455250895861,1,0.1,1,2
100,35,82.44788666393426,50,5.0,49,51
200,35,164.649866452586,94,9.4,103,97
2000,35,1744.258071363944,567,56.7,991,1009
10000,35,8879.88195250569,1148,114.8,5088,4912
20000,35,17842.119568115402,1429,142.9,10077,9923
40000,35,35815.08272272268,1781,178.1,20038,19962
60000,35,53766.463787538756,1919,191.9,30106,29894
80000,35,71842.29580920232,1955,195.5,40006,39994
100000,35,89803.34548624475,2154,215.4,49988,50012
2,36,1.5795796187131073,1,0.1,2,0
3,36,2.4438572770689735,1,0.1,3,0
100,36,86.16320838597969,50,5.0,52,48
200,36,166.675464519444,99,9.9,105,95
2000,36,1736.973053386083,535,53.5,995,1005
10000,36,8872.199844646304,1385,138.5,4988,5012
20000,36,17803.045853809977,1956,195.6,10061,9939
40000,36,35819.208716896894,2200,220.0,20018,19982
60000,36,53778.284789186815,2464,246.4,30029,29971
80000,36,71788.5905386973,2501,250.1,39928,40072
100000,36,89820.0520162111,2591,259.1,49904,50096
2,37,1.7449506925782763,1,0.1,1,1
3,37,2.6844552056642916,1,0.1,1,2
100,37,91.27746206340592,50,5.0,47,53
200,37,182.39890180981155,107,10.7,91,109
2000,37,1744.8653951146366,562,56.2,992,1008
10000,37,8902.241734383033,966,96.6,5006,4994
20000,37,17874.030389786472,1354,135.4,10023,9977
40000,37,35838.35432951676,1756,175.6,19910,20090
60000,37,53727.58514233329,1925,192.5,29971,30029
80000,37,71719.61623084327,2201,220.1,39922,40078
100000,37,89692.30446527491,2241,224.1,49989,50011
2,38,1.9650830821154817,1,0.1,1,1
3,38,3.0502519825236534,1,0.1,1,2
100,38,89.33012684916837,50,5.0,47,53
200,38,175.20538119892237,99,9.9,95,105
2000,38,1764.245263864093,536,53.6,973,1027
10000,38,8921.291409027928,1247,124.7,4955,5045
20000,38,17861.03519548873,1687,168.7,10004,9996
40000,38,35839.917885744566,2092,209.2,19975,20025
60000,38,53786.09701862766,2259,225.9,29988,30012
80000,38,71689.34694777428,2413,241.3,40021,39979
100000,38,89655.067348485,2501,250.1,50020,49980
2,39,2.2018938775644825,1,0.1,0,2
3,39,3.213376100832892,1,0.1,0,3
100,39,90.19823944117785,50,5.0,47,53
200,39,171.3220550859873,99,9.9,101,99
2000,39,1715.832908384798,588,58.8,1018,982
10000,39,8845.880648099477,1530,153.0,4973,5027
20000,39,17827.30490940309,1863,186.3,9977,10023
40000,39,35791.5686874865,1980,198.0,19981,20019
60000,39,53694.05850932,2191,219.1,30082,29918
80000,39,71642.90920137834,2260,226.0,40160,39840
100000,39,89672.62015750578,2328,232.8,50056,49944
2,40,3.0194736738620245,1,0.1,0,2
3,40,3.276669863589871,1,0.1,1,2
100,40,91.40924412697157,50,5.0,41,59
200,40,179.1080955987339,104,10.4,86,114
2000,40,1756.3078135614942,574,57.4,945,1055
10000,40,8880.99602842808,1300,130.0,4913,5087
20000,40,17836.934577885528,1896,189.6,9906,10094
40000,40,35767.253342414995,2301,230.1,19944,20056
60000,40,53711.26930361816,2779,277.9,29998,30002
80000,40,71718.4099347492,2940,294.0,39921,40079
100000,40,89673.3743133021,3137,313.7,50000,50000
2,41,0.6328251782290613,1,0.1,2,0
3,41,2.018085252590886,1,0.1,2,1
100,41,84.17554825326309,50,5.0,47,53
200,41,168.34001963867885,107,10.7,92,108
2000,41,1746.8620012668214,460,46.0,1001,999
10000,41,8848.637842700236,1253,125.3,5015,4985
20000,41,17840.905138722006,1617,161.7,9952,10048
40000,41,35812.81203022939,1972,197.2,20022,19978
60000,41,53841.683622115226,2092,209.2,30014,29986
80000,41,71863.75543612703,2284,228.4,40074,39926
100000,41,89859.41440389493,2378,237.8,50087,49913
2,42,1.7898570300897654,1,0.1,1,1
3,42,2.5746183125521807,1,0.1,2,1
100,42,81.17242904086585,50,5.0,56,44
200,42,169.65683290477665,107,10.7,104,96
2000,42,1726.624015774866,632,63.2,997,1003
10000,42,8808.744610445094,1061,106.1,5100,4900
20000,42,17746.037255487146,1458,145.8,10149,9851
40000,42,35784.835549501026,1803,180.3,20091,19909
60000,42,53760.66756884206,2017,201.7,30164,29836
80000,42,71687.48619219488,2115,211.5,40218,39782
100000,42,89655.50961848219,2174,217.4,50147,49853
2,43,1.1240590501192176,1,0.1,2,0
3,43,2.0136584036687877,1,0.1,3,0
100,43,87.54861993161661,50,5.0,48,52
200,43,172.43064941034058,107,10.7,97,103
2000,43,1710.1801286488874,612,61.2,1070,930
10000,43,8869.709913949273,1260,126.0,4998,5002
20000,43,17891.910632279574,1421,142.1,9936,10064
40000,43,35841.39232673091,1714,171.4,19985,20015
60000,43,53823.94248248666,1821,182.1,29966,30034
80000,43,71780.67126570546,1945,194.5,39917,40083
100000,43,89736.76840103393,2101,210.1,49964,50036
2,44,1.8810676229873877,1,0.1,1,1
3,44,3.219737262540652,1,0.1,1,2
100,44,94.38155161838765,50,5.0,38,62
200,44,175.2151812239501,106,10.6,90,110
2000,44,1741.7740376059583,752,75.2,981,1019
10000,44,8854.062729486252,1390,139.0,5033,4967
20000,44,17755.246351913258,1848,184.8,10076,9924
40000,44,35780.64133824074,2023,202.3,19991,20009
60000,44,53707.88080291111,2187,218.7,30126,29874
80000,44,71679.26220008309,2396,239.6,40042,39958
100000,44,89628.16726858071,2583,258.3,50135,49865
2,45,1.995445395215354,1,0.1,0,2
3,45,2.471196997887218,1,0.1,1,2
100,45,83.67671334554247,50,5.0,51,49
200,45,168.51732017874627,96,9.6,98,102
2000,45,1755.0914757196895,482,48.2,994,1006
10000,45,8909.90724955866,927,92.7,5001,4999
20000,45,17902.910774774362,1159,115.9,9948,10052
40000,45,35817.28979669789,1444,144.4,19965,20035
60000,45,53788.41939667617,1595,159.5,29981,30019
80000,45,71761.09965184868,1686,168.6,39983,40017
100000,45,89747.05750073267,1708,170.8,50012,49988
2,46,1.6069194031177072,1,0.1,2,0
3,46,2.8715509573443803,1,0.1,2,1
100,46,86.0790612319896,50,5.0,53,47
200,46,172.1238406165665,93,9.3,100,100
2000,46,1721.5790032028162,670,67.0,1011,989
10000,46,8810.65442780273,1200,120.0,5081,4919
20000,46,17774.51013171173,1468,146.8,10115,9885
40000,46,35832.01202984567,1722,172.2,20042,19958
60000,46,53772.74035432794,1972,197.2,30084,29916
80000,46,71687.17990804603,2096,209.6,40179,39821
100000,46,89599.56516991946,2150,215.0,50290,49710
2,47,1.5708290995143683,1,0.1,1,1
3,47,2.720724936951907,1,0.1,1,2
100,47,80.79768363335644,50,5.0,56,44
200,47,164.2140971829386,93,9.3,106,94
2000,47,1752.080905309676,521,52.1,969,1031
10000,47,8946.49960316617,1082,108.2,4971,5029
20000,47,17945.501037513408,1431,143.1,9918,10082
40000,47,35893.546599955705,1782,178.2,19928,20072
60000,47,53792.93448830118,1899,189.9,30040,29960
80000,47,71794.16024464677,2032,203.2,40031,39969
100000,47,89783.10582489279,2290,229.0,50029,49971
2,48,0.8666044754893094,1,0.1,2,0
3,48,1.5612618451452607,1,0.1,3,0
100,48,85.23894660409252,50,5.0,52,48
200,48,169.37380429850933,97,9.7,103,97
2000,48,1750.8730555776215,438,43.8,1020,980
10000,48,8925.649921105629,943,94.3,4979,5021
20000,48,17916.534502160983,1296,129.6,9976,10024
40000,48,35889.80658472646,1548,154.8,19956,20044
60000,48,53897.76292601662,1665,166.5,29984,30016
80000,48,71873.02315281083,1906,190.6,40032,39968
100000,48,89835.7412790905,2080,208.0,49991,50009
2,49,2.0811021797083677,1,0.1,1,1
3,49,3.3733181514709933,1,0.1,1,2
100,49,87.59421811324087,50,5.0,45,55
200,49,174.961138348868,93,9.3,94,106
2000,49,1777.13377943549,576,57.6,971,1029
10000,49,8880.365020311498,1561,156.1,4978,5022
20000,49,17856.65147720182,1932,193.2,9993,10007
40000,49,35824.20272320851,2171,217.1,19905,20095
60000,49,53737.14542086157,2388,238.8,30009,29991
80000,49,71727.33953681112,2607,260.7,40091,39909
100000,49,89746.09255939195,2769,276.9,50032,49968
2,50,1.8977539063286382,1,0.1,1,1
3,50,3.5268935042083305,1,0.1,1,2
100,50,84.20994489451759,50,5.0,47,53
200,50,174.32520399979234,94,9.4,92,108
2000,50,1767.6832035263676,481,48.1,964,1036
10000,50,8858.653998675736,1080,108.0,4960,5040
20000,50,17798.875754120698,1432,143.2,10005,9995
40000,50,35804.133078644496,1648,164.8,19936,20064
60000,50,53826.67736158956,1722,172.2,29849,30151
80000,50,71889.76361267225,1783,178.3,39743,40257
100000,50,89969.62501209293,1808,180.8,49609,50391
2,51,1.3794826446203627,1,0.1,1,1
3,51,2.2118535749154047,1,0.1,2,1
100,51,88.78416052059504,50,5.0,42,58
200,51,169.24152140692573,107,10.7,95,105
2000,51,1758.9587093540947,679,67.9,958,1042
10000,51,8854.874851273955,1430,143.0,5018,4982
20000,51,17809.713760731607,1731,173.1,10038,9962
40000,51,35763.78725236652,2144,214.4,19979,20021
60000,51,53801.164348747814,2285,228.5,29874,30126
80000,51,71804.45816984957,2313,231.3,39922,40078
100000,51,89696.97768067426,2358,235.8,50013,49987
2,52,1.656116489614484,1,0.1,1,1
3,52,2.552138679924099,1,0.1,2,1
100,52,84.73902543642491,50,5.0,56,44
200,52,167.0314172487833,93,9.3,110,90
2000,52,1749.7338260887716,565,56.5,1018,982
10000,52,8933.750221274448,981,98.1,5019,4981
20000,52,17868.80073185088,1436,143.6,10031,9969
40000,52,35766.735089314316,1876,187.6,20141,19859
60000,52,53840.52596256985,1953,195.3,29998,30002
80000,52,71862.55698974335,2039,203.9,39968,40032
100000,52,89887.88148652091,2175,217.5,49963,50037
2,53,0.7775809722048147,1,0.1,2,0
3,53,1.6442218893952691,1,0.1,3,0
100,53,82.3263026074803,50,5.0,48,52
200,53,163.84177391936433,100,10.0,102,98
2000,53,1740.964575123815,585,58.5,999,1001
10000,53,8926.918648441233,1376,137.6,4922,5078
20000,53,17907.172831324246,1641,164.1,9959,10041
40000,53,35902.25021842828,1988,198.8,19943,20057
60000,53,53839.88786843601,2314,231.4,30007,29993
80000,53,71808.62921226215,2527,252.7,40051,39949
100000,53,89773.63809316022,2593,259.3,50107,49893
2,54,0.9811178850201377,1,0.1,2,0
3,54,2.2876478447547455,1,0.1,2,1
100,54,87.66782534048734,50,5.0,46,54
200,54,170.21841573392078,98,9.8,95,105
2000,54,1753.8886832746423,482,48.2,992,1008
10000,54,8923.581984548498,866,86.6,4976,5024
20000,54,17812.616292031602,1092,109.2,10110,9890
40000,54,35804.99283967694,1309,130.9,19989,20011
60000,54,53817.6469200353,1367,136.7,29884,30116
80000,54,71800.93805538441,1405,140.5,39882,40118
100000,54,89790.25038665111,1428,142.8,49928,50072
2,55,1.0830880986141547,1,0.1,2,0
3,55,1.9041318636984437,1,0.1,3,0
100,55,84.71901193735305,50,5.0,55,45
200,55,171.83775958382984,93,9.3,103,97
2000,55,1722.2795245294835,563,56.3,1050,950
10000,55,8881.760823461429,1118,111.8,4992,5008
20000,55,17795.6593439554,1467,146.7,10031,9969
40000,55,35789.99794745448,1616,161.6,19946,20054
60000,55,53743.97611882414,1817,181.7,29983,30017
80000,55,71804.9846147591,1849,184.9,39944,40056
100000,55,89776.57097933775,1968,196.8,49937,50063
2,56,1.9815963073444804,1,0.1,1,1
3,56,2.8130657429107213,1,0.1,2,1
100,56,81.8973246377821,50,5.0,60,40
200,56,171.2343842115325,93,9.3,105,95
2000,56,1761.1765623184406,411,41.1,1004,996
10000,56,8948.467650688024,1123,112.3,4926,5074
20000,56,17940.627060379044,1494,149.4,9866,10134
40000,56,36038.126132614416,1694,169.4,19707,20293
60000,56,54082.09195952504,1760,176.0,29562,30438
80000,56,72017.9401945729,1994,199.4,39639,40361
100000,56,89988.18175093489,2046,204.6,49628,50372
2,57,0.8189044248190138,1,0.1,2,0
3,57,1.6675093022970024,1,0.1,3,0
100,57,89.11023862377583,50,5.0,45,55
200,57,175.24171635351385,93,9.3,94,106
2000,57,1760.6859704604733,434,43.4,975,1025
10000,57,8866.68007282312,1243,124.3,4978,5022
20000,57,17854.047783847713,1488,148.8,9959,10041
40000,57,35792.24833249524,1823,182.3,19995,20005
60000,57,53787.4416812009,1898,189.8,30016,29984
80000,57,71726.66240310972,2010,201.0,40151,39849
100000,57,89806.75232267215,2028,202.8,50060,49940
2,58,1.391455364444109,1,0.1,1,1
3,58,2.1483898384053335,1,0.1,2,1
100,58,85.21585570361408,50,5.0,53,47
200,58,168.81435840096157,95,9.5,106,94
2000,58,1744.1819149321166,565,56.5,985,1015
10000,58,8906.892501111892,1234,123.4,4960,5040
20000,58,17868.54862103187,1599,159.9,9953,10047
40000,58,35765.265281265456,2040,204.0,20116,19884
60000,58,53763.8709929551,2185,218.5,30140,29860
80000,58,71706.62491754965,2256,225.6,40209,39791
100000,58,89737.98310185727,2357,235.7,50209,49791
2,59,1.8183286017744114,1,0.1,0,2
3,59,3.061789622350452,1,0.1,0,3
100,59,85.06581312565238,50,5.0,48,52
200,59,171.9157942755837,105,10.5,89,111
2000,59,1753.4769038000568,465,46.5,993,1007
10000,59,8873.045589635181,1193,119.3,5037,4963
20000,59,17806.72929090892,1547,154.7,10153,9847
40000,59,35822.896156142895,1645,164.5,20170,19830
60000,59,53913.48387198682,1768,176.8,30066,29934
80000,59,71877.55879131361,1941,194.1,40127,39873
100000,59,89853.53455180014,2028,202.8,50141,49859
2,60,0.9792527234761745,1,0.1,2,0
3,60,2.303945599537458,1,0.1,2,1
100,60,85.07479771839792,50,5.0,47,53
200,60,167.95793983145325,107,10.7,95,105
2000,60,1743.723958339045,505,50.5,1025,975
10000,60,8925.192693109731,1350,135.0,5000,5000
20000,60,17909.469684555035,1706,170.6,9986,10014
40000,60,35810.21222277073,2262,226.2,20039,19961
60000,60,53785.61631948693,2419,241.9,30066,29934
80000,60,71774.64714683154,2527,252.7,40084,39916
100000,60,89769.96205392876,2620,262.0,50055,49945
2,61,0.7074510927606069,1,0.1,2,0
3,61,1.62139720946463,1,0.1,2,1
100,61,82.19284319841995,50,5.0,55,45
200,61,163.27271689524946,93,9.3,110,90
2000,61,1735.6478164717137,534,53.4,985,1015
10000,61,8821.684105031016,1307,130.7,5043,4957
20000,61,17821.95968198903,1512,151.2,9992,10008
40000,61,35777.17285693386,1788,178.8,20108,19892
60000,61,53764.62012183321,1928,192.8,30105,29895
80000,61,71719.45474423644,2043,204.3,40148,39852
100000,61,89728.61323357355,2162,216.2,50125,49875
2,62,1.7549730849384457,1,0.1,1,1
3,62,2.8348735885577288,1,0.1,1,2
100,62,80.75068799692048,50,5.0,51,49
200,62,166.02157933788945,93,9.3,101,99
2000,62,1745.9986590762028,588,58.8,993,1007
10000,62,8819.50449520477,1417,141.7,5073,4927
20000,62,17752.278562283547,1585,158.5,10179,9821
40000,62,35658.39564316778,1934,193.4,20184,19816
60000,62,53683.80321239023,2019,201.9,30040,29960
80000,62,71593.16849351539,2198,219.8,40067,39933
100000,62,89545.6632505105,2261,226.1,50148,49852
2,63,1.8813199471395108,1,0.1,1,1
3,63,2.8726546556008588,1,0.1,1,2
100,63,89.54583154335377,50,5.0,47,53
200,63,172.09878724858117,93,9.3,105,95
2000,63,1766.8499584168028,422,42.2,992,1008
10000,63,8908.556250081474,902,90.2,4961,5039
20000,63,17862.858096737586,1170,117.0,10035,9965
40000,63,35835.53976833874,1460,146.0,20083,19917
60000,63,53820.11199946091,1587,158.7,30039,29961
80000,63,71847.21187185773,1741,174.1,39977,40023
100000,63,89859.46469130578,1814,181.4,49882,50118
2,64,1.4903872004290672,1,0.1,1,1
3,64,3.265750143902006,1,0.1,1,2
100,64,82.7724860974659,50,5.0,50,50
200,64,164.10057161506637,93,9.3,104,96
2000,64,1739.5575987987816,543,54.3,986,1014
10000,64,8899.482018309129,1137,113.7,4943,5057
20000,64,17896.020318972223,1295,129.5,9901,10099
40000,64,35846.45292842277,1482,148.2,19956,20044
60000,64,53892.33478021942,1732,173.2,29886,30114
80000,64,71867.60762562332,1873,187.3,39982,40018
100000,64,89863.72413777691,2116,211.6,49981,50019
2,65,0.8911621464123283,1,0.1,2,0
3,65,1.8265758996061903,1,0.1,2,1
100,65,71.6958557001842,50,5.0,62,38
200,65,161.73969591517022,93,9.3,110,90
2000,65,1729.220832219771,532,53.2,1009,991
10000,65,8870.924394139005,1315,131.5,4982,5018
20000,65,17854.869872012896,1532,153.2,9977,10023
40000,65,35801.89870395023,1776,177.6,20070,19930
60000,65,53787.152908474585,1987,198.7,30084,29916
80000,65,71736.46835081751,2181,218.1,40066,39934
100000,65,89736.870079753,2252,225.2,50106,49894
2,66,1.35353042573839,1,0.1,1,1
3,66,2.5971633454276772,1,0.1,1,2
100,66,75.84648235438603,50,5.0,62,38
200,66,158.73837876220875,107,10.7,116,84
2000,66,1718.4382059355287,634,63.4,1023,977
10000,66,8796.660490770531,1545,154.5,5121,4879
20000,66,17776.34126480212,1864,186.4,10055,9945
40000,66,35742.17278185952,2143,214.3,20126,19874
60000,66,53792.83936505801,2199,219.9,30097,29903
80000,66,71806.5343090122,2383,238.3,40005,39995
100000,66,89814.60373668998,2454,245.4,49945,50055
2,67,1.7577119149602116,1,0.1,1,1
3,67,2.845190754112658,1,0.1,1,2
100,67,83.30119727849188,50,5.0,53,47
200,67,167.10762787943432,103,10.3,102,98
2000,67,1732.2519991774939,551,55.1,1023,977
10000,67,8887.269329925892,1223,122.3,4964,5036
20000,67,17908.957140995655,1494,149.4,9911,10089
40000,67,35927.67338241318,1771,177.1,19895,20105
60000,67,53971.02513641461,1974,197.4,29805,30195
80000,67,71912.3118097267,2114,211.4,39785,40215
100000,67,89863.18730464827,2341,234.1,49867,50133
2,68,1.3169895570934271,1,0.1,1,1
3,68,2.5180685144547716,1,0.1,1,2
100,68,84.55733987434144,50,5.0,51,49
200,68,165.9468544974151,93,9.3,103,97
2000,68,1762.3349494422089,479,47.9,982,1018
10000,68,8915.873655703093,1344,134.4,4973,5027
20000,68,17912.19232479541,1795,179.5,9914,10086
40000,68,35875.64435753991,2095,209.5,19954,20046
60000,68,53922.90971865097,2203,220.3,29876,30124
80000,68,71951.46763572942,2394,239.4,39843,40157
100000,68,89935.72944471118,2463,246.3,49917,50083
2,69,0.9289557547654965,1,0.1,2,0
3,69,1.435072866461796,1,0.1,3,0
100,69,82.61453603844926,50,5.0,57,43
200,69,161.72054635692416,107,10.7,113,87
2000,69,1736.390095871984,381,38.1,1032,968
10000,69,8938.96968833764,941,94.1,4989,5011
20000,69,17879.56618955281,1396,139.6,10038,9962
40000,69,35792.12444877852,1670,167.0,20081,19919
60000,69,53806.858520402806,1744,174.4,30024,29976
80000,69,71823.66891671701,1789,178.9,39943,40057
100000,69,89871.28274079149,1846,184.6,49892,50108
2,70,1.8536771878263076,1,0.1,1,1
3,70,2.6875853837568844,1,0.1,2,1
100,70,84.93474566700928,50,5.0,49,51
200,70,170.3965432071524,93,9.3,94,106
2000,70,1763.0530521481448,529,52.9,975,1025
10000,70,8886.90489122955,1200,120.0,5014,4986
20000,70,17904.423492287082,1457,145.7,9908,10092
40000,70,35861.10058500412,1751,175.1,19932,20068
60000,70,53853.23744296829,1880,188.0,30017,29983
80000,70,71795.73586590996,1957,195.7,40073,39927
100000,70,89931.26965564817,2111,211.1,49894,50106
2,71,1.8243419053393986,1,0.1,1,1
3,71,2.791944169132808,1,0.1,1,2
100,71,82.92799041204748,50,5.0,48,52
200,71,169.73178843474577,99,9.9,94,106
2000,71,1736.070910819211,431,43.1,1007,993
10000,71,8888.614780792725,869,86.9,4993,5007
20000,71,17937.973966769237,1041,104.1,9879,10121
40000,71,35928.527374242854,1434,143.4,19832,20168
60000,71,53936.690364577225,1636,163.6,29775,30225
80000,71,72000.36678141486,1663,166.3,39684,40316
100000,71,89957.69752383052,1739,173.9,49713,50287
2,72,2.0914877754814283,1,0.1,1,1
3,72,2.7005001957821166,1,0.1,2,1
100,72,85.8095258142813,50,5.0,48,52
200,72,171.80464792414335,107,10.7,93,107
2000,72,1756.6669580151859,430,43.0,982,1018
10000,72,8899.597577088902,1295,129.5,4947,5053
20000,72,17844.767909691625,1613,161.3,9953,10047
40000,72,35834.107988304764,1802,180.2,19861,20139
60000,72,53908.68787578054,2171,217.1,29799,30201
80000,72,71845.55908148117,2385,238.5,39884,40116
100000,72,89817.77605002129,2466,246.6,49955,50045
2,73,2.294997267299249,1,0.1,0,2
3,73,3.593545353478772,1,0.1,0,3
100,73,88.28470247655072,50,5.0,46,54
200,73,173.39554610350098,93,9.3,97,103
2000,73,1733.4037457584136,689,68.9,991,1009
10000,73,8836.411797268609,1791,179.1,4975,5025
20000,73,17769.849126912708,2259,225.9,10019,9981
40000,73,35715.69325049388,2597,259.7,20016,19984
60000,73,53742.495492802205,2755,275.5,30019,29981
80000,73,71740.24540563286,2845,284.5,40030,39970
100000,73,89761.01301445096,2955,295.5,49979,50021
2,74,2.255815393589034,1,0.1,0,2
3,74,2.963194426579907,1,0.1,1,2
100,74,80.18055000102432,50,5.0,51,49
200,74,166.55605130455513,107,10.7,102,98
2000,74,1745.0655978133423,683,68.3,977,1023
10000,74,8872.239228284612,1442,144.2,4996,5004
20000,74,17839.29848467678,1717,171.7,9975,10025
40000,74,35833.12579872683,1994,199.4,19951,20049
60000,74,53781.83196503176,2254,225.4,29919,30081
80000,74,71765.58538701078,2376,237.6,40028,39972
100000,74,89817.79564535302,2451,245.1,49923,50077
2,75,1.0136401304306164,1,0.1,2,0
3,75,1.5490231568762176,1,0.1,3,0
100,75,88.49014559524144,50,5.0,45,55
200,75,177.37199418520194,107,10.7,89,111
2000,75,1759.1697641844362,641,64.1,968,1032
10000,75,8932.511964128593,1373,137.3,4901,5099
20000,75,17945.443951907622,1728,172.8,9840,10160
40000,75,35958.88287470046,2058,205.8,19735,20265
60000,75,53889.07916471409,2225,222.5,29839,30161
80000,75,71820.73443779652,2291,229.1,39950,40050
100000,75,89859.40194136355,2510,251.0,49871,50129
2,76,1.963349163924057,1,0.1,0,2
3,76,2.5988834242852077,1,0.1,1,2
100,76,87.12052933073808,50,5.0,48,52
200,76,174.8802069634304,95,9.5,96,104
2000,76,1735.7087218516406,520,52.0,1024,976
10000,76,8847.678740158162,1185,118.5,5009,4991
20000,76,17769.59053311791,1624,162.4,10002,9998
40000,76,35793.24214012151,1787,178.7,19984,20016
60000,76,53762.75349909812,2049,204.9,29981,30019
80000,76,71788.1869557139,2108,210.8,39955,40045
100000,76,89761.54731186567,2200,220.0,49943,50057
2,77,2.1041618734209515,1,0.1,1,1
3,77,3.3921639499894045,1,0.1,1,2
100,77,80.64116264767716,50,5.0,52,48
200,77,165.3035407133021,93,9.3,107,93
2000,77,1738.3631681130862,516,51.6,1023,977
10000,77,8866.55902643914,1035,103.5,5056,4944
20000,77,17808.302292987948,1562,156.2,10127,9873
40000,77,35880.77081147527,1840,184.0,20008,19992
60000,77,53813.12670726136,2007,200.7,30095,29905
80000,77,71789.770933803,2096,209.6,40102,39898
100000,77,89693.75363666246,2172,217.2,50142,49858
2,78,2.387158106423265,1,0.1,0,2
3,78,3.342164704933473,1,0.1,0,3
100,78,85.89643217247962,50,5.0,48,52
200,78,170.34892773936284,107,10.7,100,100
2000,78,1734.2813695665354,567,56.7,1032,968
10000,78,8871.053370978556,1193,119.3,4979,5021
20000,78,17860.299354483777,1463,146.3,9979,10021
40000,78,35841.739927759976,1651,165.1,20101,19899
60000,78,53726.900676523175,1926,192.6,30143,29857
80000,78,71715.95231632258,1979,197.9,40112,39888
100000,78,89616.4667159108,2201,220.1,50147,49853
2,79,2.350275595002795,1,0.1,0,2
3,79,2.910091064336435,1,0.1,1,2
100,79,84.50372740756323,50,5.0,51,49
200,79,173.49903735590158,93,9.3,97,103
2000,79,1764.7730585370302,492,49.2,979,1021
10000,79,8888.25306019059,1331,133.1,4971,5029
20000,79,17914.42404987484,1471,147.1,9894,10106
40000,79,35839.19379696551,1867,186.7,19891,20109
60000,79,53850.83853077349,1948,194.8,29898,30102
80000,79,71737.09198201935,2035,203.5,40114,39886
100000,79,89717.61352769725,2108,210.8,50098,49902
2,80,1.2651840396114786,1,0.1,1,1
3,80,2.8603604594686036,1,0.1,1,2
100,80,85.7362655912096,50,5.0,49,51
200,80,177.7834866012811,107,10.7,91,109
2000,80,1764.1972125090997,750,75.0,975,1025
10000,80,8894.529841880672,1581,158.1,4968,5032
20000,80,17886.011405397603,1874,187.4,9934,10066
40000,80,35870.59227026955,2222,222.2,19920,20080
60000,80,53862.43715218908,2619,261.9,29931,30069
80000,80,71807.2513424469,2785,278.5,39960,40040
100000,80,89800.69075598987,2930,293.0,49943,50057
2,81,1.8933307139942948,1,0.1,0,2
3,81,3.2607948515405107,1,0.1,0,3
100,81,87.15768068899914,50,5.0,48,52
200,81,172.70031995677772,107,10.7,103,97
2000,81,1765.610422996305,468,46.8,980,1020
10000,81,8883.20079038775,1221,122.1,4942,5058
20000,81,17866.40559033456,1379,137.9,9993,10007
40000,81,35936.36487744416,1490,149.0,19964,20036
60000,81,53875.24878048609,1594,159.4,30087,29913
80000,81,71881.98999119872,1741,174.1,40052,39948
100000,81,89850.81562979809,2158,215.8,50084,49916
2,82,1.1171303581175087,1,0.1,2,0
3,82,1.9921838060532744,1,0.1,3,0
100,82,87.03578518188492,50,5.0,53,47
200,82,171.9156129028228,93,9.3,109,91
2000,82,1730.219351033211,478,47.8,1032,968
10000,82,8859.522823455407,974,97.4,5084,4916
20000,82,17759.165291106576,1534,153.4,10170,9830
40000,82,35735.20679209249,1753,175.3,20099,19901
60000,82,53693.384492419355,1976,197.6,30169,29831
80000,82,71663.36343865284,2020,202.0,40107,39893
100000,82,89662.13963590248,2117,211.7,50160,49840
2,83,1.4260904083502708,1,0.1,2,0
3,83,2.8666960376067205,1,0.1,2,1
100,83,82.73618350448315,50,5.0,62,38
200,83,174.44408994147045,107,10.7,105,95
2000,83,1761.5093148563492,518,51.8,994,1006
10000,83,8899.233895599387,1271,127.1,4936,5064
20000,83,17808.543546637946,1652,165.2,9961,10039
40000,83,35798.60822794872,1936,193.6,19938,20062
60000,83,53736.77911873441,2071,207.1,30112,29888
80000,83,71680.33517172906,2151,215.1,40296,39704
100000,83,89627.77401638316,2188,218.8,50283,49717
2,84,0.8887257319932146,1,0.1,2,0
3,84,1.7273840568093095,1,0.1,3,0
100,84,91.5723681669877,50,5.0,41,59
200,84,174.47994190874496,106,10.6,93,107
2000,84,1761.7913340953364,535,53.5,990,1010
10000,84,8874.37175395777,1206,120.6,5010,4990
20000,84,17875.382542761938,1492,149.2,10011,9989
40000,84,35844.98824984813,1795,179.5,19946,20054
60000,84,53846.33343296488,1947,194.7,29901,30099
80000,84,71802.98453305574,2080,208.0,39961,40039
100000,84,89857.03666971318,2128,212.8,49921,50079
2,85,1.5297086440124343,1,0.1,1,1
3,85,2.0198549908007903,1,0.1,2,1
100,85,86.1273735661617,50,5.0,49,51
200,85,174.59147620415172,95,9.5,92,108
2000,85,1758.297704238247,433,43.3,993,1007
10000,85,8856.565941260893,904,90.4,5024,4976
20000,85,17838.799871976327,1105,110.5,9980,10020
40000,85,35850.583156589084,1467,146.7,19916,20084
60000,85,53865.485874345635,1546,154.6,29841,30159
80000,85,71754.65689349892,1728,172.8,40041,39959
100000,85,89723.91883490092,1957,195.7,50029,49971
2,86,1.7765928788346157,1,0.1,0,2
3,86,2.58984997709296,1,0.1,1,2
100,86,82.14296678467555,50,5.0,51,49
200,86,165.32970624806418,93,9.3,104,96
2000,86,1743.599530811666,332,33.2,1041,959
10000,86,8865.01352109733,1073,107.3,5058,4942
20000,86,17809.7616126693,1409,140.9,10081,9919
40000,86,35713.40627622463,1716,171.6,20209,19791
60000,86,53635.77305495074,1842,184.2,30246,29754
80000,86,71667.4553387163,1880,188.0,40195,39805
100000,86,89663.75809886973,2026,202.6,50133,49867
2,87,1.176851905726553,1,0.1,1,1
3,87,1.7614119167132525,1,0.1,2,1
100,87,83.63019548137163,50,5.0,48,52
200,87,166.78751462316606,104,10.4,103,97
2000,87,1744.4271439500474,497,49.7,994,1006
10000,87,8919.558721009425,925,92.5,4989,5011
20000,87,17858.292698538502,1248,124.8,10074,9926
40000,87,35792.1729852588,1412,141.2,20073,19927
60000,87,53738.2608535836,1588,158.8,30162,29838
80000,87,71681.18814427457,1886,188.6,40187,39813
100000,87,89662.6146068403,2023,202.3,50184,49816
2,88,1.4382434158759199,1,0.1,1,1
3,88,2.007922931170527,1,0.1,2,1
100,88,79.91261423524985,50,5.0,56,44
200,88,166.97035407297844,97,9.7,101,99
2000,88,1738.1402187384488,678,67.8,994,1006
10000,88,8851.385989147619,1333,133.3,5039,4961
20000,88,17809.248194982294,1640,164.0,10013,9987
40000,88,35737.49686243718,1961,196.1,20070,19930
60000,88,53701.312258894475,2131,213.1,30047,29953
80000,88,71658.42578778129,2293,229.3,40105,39895
100000,88,89644.81395872461,2322,232.2,50083,49917
2,89,1.997774291631691,1,0.1,1,1
3,89,3.0290947764504317,1,0.1,1,2
100,89,87.40837988475172,50,5.0,49,51
200,89,173.3980941929274,96,9.6,102,98
2000,89,1761.3557927846318,434,43.4,972,1028
10000,89,8926.274002610044,938,93.8,4900,5100
20000,89,17890.668665200654,1402,140.2,9898,10102
40000,89,35830.841553014936,1570,157.0,19978,20022
60000,89,53762.579536210054,2517,251.7,29933,30067
80000,89,71746.14996714467,2659,265.9,39923,40077
100000,89,89810.17121144186,2691,269.1,49816,50184
2,90,1.9868665995630774,1,0.1,0,2
3,90,2.96604627386461,1,0.1,0,3
100,90,87.2058975184335,50,5.0,50,50
200,90,172.85028116939438,93,9.3,100,100
2000,90,1754.9703730972121,592,59.2,975,1025
10000,90,8872.452210102598,1330,133.0,5012,4988
20000,90,17919.92124985446,1604,160.4,9915,10085
40000,90,35931.874684174545,1787,178.7,19857,20143
60000,90,53901.16583833644,1983,198.3,29925,30075
80000,90,71829.99518945166,2136,213.6,39989,40011
100000,90,89778.48316126032,2155,215.5,50010,49990
2,91,1.3890036825029237,1,0.1,2,0
3,91,2.4402938126942164,1,0.1,2,1
100,91,80.63286051769366,50,5.0,54,46
200,91,166.8603858691744,98,9.8,100,100
2000,91,1695.32795068418,634,63.4,1042,958
10000,91,8871.841908049708,1021,102.1,5038,4962
20000,91,17862.251093674047,1324,132.4,10041,9959
40000,91,35796.2112679928,1794,179.4,20000,20000
60000,91,53745.26725254098,1983,198.3,30042,29958
80000,91,71766.55277030231,2075,207.5,39998,40002
100000,91,89756.6817456682,2254,225.4,50005,49995
2,92,0.9465056149397657,1,0.1,2,0
3,92,1.5695408948364236,1,0.1,3,0
100,92,81.40132242904518,50,5.0,55,45
200,92,163.61673993173756,107,10.7,108,92
2000,92,1727.2591740353794,733,73.3,1005,995
10000,92,8872.438174208428,1433,143.3,4968,5032
20000,92,17805.54651737318,1766,176.6,10021,9979
40000,92,35730.828466905725,2035,203.5,20055,19945
60000,92,53654.75945811269,2132,213.2,30144,29856
80000,92,71647.52406734675,2275,227.5,40096,39904
100000,92,89660.90199568936,2418,241.8,50025,49975
2,93,2.1047355866751785,1,0.1,1,1
3,93,2.3622136433453336,1,0.1,2,1
100,93,85.83893625948608,50,5.0,50,50
200,93,166.24367519698373,98,9.8,100,100
2000,93,1720.439766722903,565,56.5,1011,989
10000,93,8831.462394157255,1032,103.2,5083,4917
20000,93,17814.17363830774,1359,135.9,10035,9965
40000,93,35817.498521432106,1705,170.5,19920,20080
60000,93,53768.470505242476,1819,181.9,29909,30091
80000,93,71837.81466607371,1902,190.2,39830,40170
100000,93,89774.6703155385,1944,194.4,49858,50142
2,94,1.4984521493611824,1,0.1,2,0
3,94,1.8405711692996265,1,0.1,3,0
100,94,86.26900360089586,50,5.0,52,48
200,94,166.76299055473987,107,10.7,106,94
2000,94,1731.4236870493155,604,60.4,1025,975
10000,94,8887.242805238911,1339,133.9,5000,5000
20000,94,17776.869272183176,1957,195.7,10031,9969
40000,94,35748.14313375844,2287,228.7,20040,19960
60000,94,53771.642731164146,2656,265.6,29985,30015
80000,94,71847.1496999817,2690,269.0,39867,40133
100000,94,89817.40437871934,2778,277.8,49883,50117
2,95,1.804170643733641,1,0.1,1,1
3,95,2.860702672330173,1,0.1,1,2
100,95,86.68010415021338,50,5.0,48,52
200,95,175.30784774082196,93,9.3,95,105
2000,95,1739.7778832344975,654,65.4,985,1015
10000,95,8907.615453375582,1251,125.1,4973,5027
20000,95,17876.338778474674,1643,164.3,10017,9983
40000,95,35883.44687538067,1874,187.4,19963,20037
60000,95,53840.60175769358,2158,215.8,30004,29996
80000,95,71774.28627799796,2221,222.1,40026,39974
100000,95,89814.69359463776,2240,224.0,49946,50054
2,96,1.8798663946141585,1,0.1,1,1
3,96,2.776494313153495,1,0.1,2,1
100,96,81.0866169443111,50,5.0,54,46
200,96,165.38206218627255,93,9.3,101,99
2000,96,1726.590388037288,666,66.6,989,1011
10000,96,8879.794583165629,1362,136.2,4932,5068
20000,96,17861.168262026906,1632,163.2,9886,10114
40000,96,35836.64038526587,1912,191.2,19805,20195
60000,96,53869.05421271889,2035,203.5,29759,30241
80000,96,71898.13794709273,2083,208.3,39745,40255
100000,96,89877.31745466488,2217,221.7,49758,50242
2,97,2.451895051726722,1,0.1,0,2
3,97,3.313236476556254,1,0.1,1,2
100,97,79.38849339686104,50,5.0,58,42
200,97,163.9659263625187,93,9.3,108,92
2000,97,1734.0631573686328,582,58.2,1001,999
10000,97,8874.554861285336,1363,136.3,5031,4969
20000,97,17828.235575953226,1689,168.9,10149,9851
40000,97,35773.100906850035,2061,206.1,20272,19728
60000,97,53745.78313317552,2173,217.3,30370,29630
80000,97,71762.23798970005,2236,223.6,40325,39675
100000,97,89720.68775044943,2425,242.5,50437,49563
2,98,1.9550404959638754,1,0.1,1,1
3,98,2.803135212425639,1,0.1,2,1
100,98,87.3261237462697,50,5.0,46,54
200,98,174.0237304322164,107,10.7,91,109
2000,98,1755.2085464222514,524,52.4,972,1028
10000,98,8838.633122028648,1327,132.7,5019,4981
20000,98,17744.514050414942,2039,203.9,10035,9965
40000,98,35721.968063089626,2306,230.6,20018,19982
60000,98,53761.782431772706,2554,255.4,29924,30076
80000,98,71721.99495173214,2801,280.1,39939,40061
100000,98,89701.79938565967,2963,296.3,49895,50105
2,99,1.1179024714793542,1,0.1,2,0
3,99,2.2358564924445146,1,0.1,2,1
100,99,93.06103844055856,50,5.0,43,57
200,99,173.38187691746376,107,10.7,93,107
2000,99,1795.4397629716082,525,52.5,909,1091
10000,99,8952.752831513457,1320,132.0,4895,5105
20000,99,17976.723803695593,1637,163.7,9876,10124
40000,99,35968.497271746055,1982,198.2,19815,20185
60000,99,53927.194588513645,2308,230.8,29880,30120
80000,99,71959.54178459093,2351,235.1,39922,40078
100000,99,89987.12184370101,2424,242.4,49877,50123
2,100,1.6234113362226381,1,0.1,1,1
3,100,2.4747589307958724,1,0.1,2,1
100,100,88.41452908285282,50,5.0,44,56
200,100,169.9062517572655,104,10.4,98,102
2000,100,1741.957858456928,527,52.7,1005,995
10000,100,8934.610424649414,999,99.9,4911,5089
20000,100,17919.683302544647,1400,140.0,9842,10158
40000,100,35887.12984267971,2164,216.4,19715,20285
60000,100,53717.71249440565,2357,235.7,29932,30068
80000,100,71725.84942674988,2404,240.4,39983,40017
100000,100,89740.0631378293,2465,246.5,50029,49971
