Timestep,Iteration,Total Reward,Suboptimal Arms,Total Regret,Zeros Count,Ones Count
2,1,1.866607983396689,1,0.01,1,1
3,1,2.829167682302182,1,0.01,2,1
100,1,89.08664346336074,63,0.32,71,29
200,1,173.24311770522104,157,0.79,130,70
2000,1,1807.6354775920756,1939,9.7,1012,988
10000,1,8935.666909423084,9926,49.63,5086,4914
20000,1,17899.49028844017,19920,99.6,10096,9904
40000,1,35770.218649874245,39915,199.57,20154,19846
60000,1,53679.52434161534,59911,299.55,30081,29919
80000,1,71615.90974515254,79909,399.54,40100,39900
100000,1,89446.16422491397,99907,499.53,50153,49847
2,2,2.1173699051147827,1,0.01,1,1
3,2,2.705588234935006,1,0.01,2,1
100,2,93.40577716594008,63,0.32,63,37
200,2,176.68951096799518,157,0.79,121,79
2000,2,1784.7485388550174,1939,9.7,1032,968
10000,2,8927.450135520157,9926,49.63,5115,4885
20000,2,17867.46901971148,19920,99.6,10023,9977
40000,2,35734.73181456586,39915,199.57,20184,19816
60000,2,53604.46019336012,59911,299.55,30199,29801
80000,2,71621.04964535237,79909,399.54,40028,39972
100000,2,89516.51262215927,99907,499.53,50041,49959
2,3,2.181273547696989,1,0.01,1,1
3,3,3.084001343402695,1,0.01,2,1
100,3,91.61688740213238,63,0.32,67,33
200,3,181.85763437636896,157,0.79,114,86
2000,3,1806.9324282555285,1939,9.7,1022,978
10000,3,8910.068609156697,9926,49.63,5083,4917
20000,3,17902.031170290244,19920,99.6,9984,10016
40000,3,35916.20979579921,39915,199.57,19905,20095
60000,3,53763.66708831199,59911,299.55,30005,29995
80000,3,71574.06362141558,79909,399.54,40113,39887
100000,3,89578.45368255304,99907,499.53,50046,49954
2,4,1.3798440288435159,1,0.01,2,0
3,4,2.4248971652522826,1,0.01,3,0
100,4,82.35894135721745,63,0.32,78,22
200,4,181.2810892375348,157,0.79,118,82
2000,4,1774.0765955040667,1939,9.7,1089,911
10000,4,9031.367901553418,9926,49.63,4952,5048
20000,4,17918.945833941863,19920,99.6,9966,10034
40000,4,35819.54142042729,39915,199.57,20035,19965
60000,4,53790.82777376508,59911,299.55,29979,30021
80000,4,71456.86337779874,79909,399.54,40209,39791
100000,4,89518.05800042833,99907,499.53,49964,50036
2,5,1.703225238950075,1,0.01,2,0
3,5,2.3359334721671567,1,0.01,3,0
100,5,87.83883174895955,63,0.32,72,28
200,5,177.91148532817,157,0.79,126,74
2000,5,1806.0566980559536,1939,9.7,1030,970
10000,5,8911.381170310255,9926,49.63,5095,4905
20000,5,17905.23670054292,19920,99.6,9992,10008
40000,5,35968.85860307169,39915,199.57,19823,20177
60000,5,53697.90434784155,59911,299.55,30017,29983
80000,5,71681.5053443271,79909,399.54,39865,40135
100000,5,89487.44646108848,99907,499.53,49860,50140
2,6,1.5706993621140937,1,0.01,2,0
3,6,2.6616789962231078,1,0.01,3,0
100,6,91.18578363216871,63,0.32,62,38
200,6,184.59969231053955,157,0.79,112,88
2000,6,1785.7483694625541,1939,9.7,1003,997
10000,6,8932.548353221177,9926,49.63,5043,4957
20000,6,17956.508887571385,19920,99.6,9870,10130
40000,6,35751.47741909136,39915,199.57,20131,19869
60000,6,53776.682840460286,59911,299.55,29863,30137
80000,6,71669.21338455543,79909,399.54,39892,40108
100000,6,89565.40227297544,99907,499.53,49826,50174
2,7,1.5671438187040416,1,0.01,2,0
3,7,2.701485517626086,1,0.01,2,1
100,7,90.50499423765727,63,0.32,67,33
200,7,176.44559248962724,157,0.79,125,75
2000,7,1791.0023458560547,1939,9.7,1033,967
10000,7,8913.082537076169,9926,49.63,5123,4877
20000,7,17915.91375897129,19920,99.6,9920,10080
40000,7,35722.70674555468,39915,199.57,20179,19821
60000,7,53596.71614422474,59911,299.55,30145,29855
80000,7,71659.52919556249,79909,399.54,39977,40023
100000,7,89500.62038346624,99907,499.53,50027,49973
2,8,1.713367647141423,1,0.01,2,0
3,8,2.8319318853281183,1,0.01,2,1
100,8,91.41805461806374,63,0.32,64,36
200,8,175.80693463734832,157,0.79,133,67
2000,8,1812.6455174525945,1939,9.7,988,1012
10000,8,8967.195695610764,9926,49.63,5028,4972
20000,8,17845.34093351067,19920,99.6,10059,9941
40000,8,35780.89109955058,39915,199.57,20087,19913
60000,8,53671.661973121125,59911,299.55,29892,30108
80000,8,71766.0823464504,79909,399.54,39934,40066
100000,8,89387.35821219398,99907,499.53,50321,49679
2,9,1.3600719955405085,1,0.01,2,0
3,9,2.8305533688519793,1,0.01,2,1
100,9,86.35848678201327,63,0.32,69,31
200,9,180.37318337753172,157,0.79,119,81
2000,9,1789.9303167419753,1939,9.7,1040,960
10000,9,8921.91340176243,9926,49.63,5030,4970
20000,9,17899.41145368379,19920,99.6,10050,9950
40000,9,35880.21354562226,39915,199.57,19940,20060
60000,9,53741.01547079886,59911,299.55,30077,29923
80000,9,71622.56892358446,79909,399.54,39886,40114
100000,9,89377.8332694758,99907,499.53,50033,49967
2,10,2.0825906335294246,1,0.01,1,1
3,10,2.5771179940035847,1,0.01,3,0
100,10,88.67584006817494,63,0.32,69,31
200,10,180.39741621170998,157,0.79,123,77
2000,10,1777.1136445955212,1939,9.7,1062,938
10000,10,8997.976970556532,9926,49.63,4959,5041
20000,10,17924.91161594006,19920,99.6,10005,9995
40000,10,35695.105453442935,39915,199.57,20372,19628
60000,10,53744.32734342486,59911,299.55,29858,30142
80000,10,71585.3519070813,79909,399.54,40093,39907
100000,10,89457.04771847608,99907,499.53,50036,49964
2,11,2.152336141761704,1,0.01,1,1
3,11,2.354143662200066,1,0.01,3,0
100,11,87.55178887480142,63,0.32,69,31
200,11,184.06092871335414,157,0.79,118,82
2000,11,1777.1652066410322,1939,9.7,1047,953
10000,11,8948.924138219216,9926,49.63,4997,5003
20000,11,17953.072545937663,19920,99.6,9987,10013
40000,11,35766.829378224786,39915,199.57,20037,19963
60000,11,53641.52061846139,59911,299.55,30109,29891
80000,11,71498.22397200753,79909,399.54,40176,39824
100000,11,89621.76829290122,99907,499.53,50021,49979
2,12,1.9343335111430662,1,0.01,1,1
3,12,2.355941832783533,1,0.01,3,0
100,12,91.3307616540065,63,0.32,64,36
200,12,172.8299288977986,157,0.79,131,69
2000,12,1807.0137795263745,1939,9.7,1001,999
10000,12,8973.11418749769,9926,49.63,4991,5009
20000,12,17891.049335744792,19920,99.6,9989,10011
40000,12,35658.68886533966,39915,199.57,20148,19852
60000,12,53620.41439851603,59911,299.55,30180,29820
80000,12,71592.63180591365,79909,399.54,40133,39867
100000,12,89420.21553130222,99907,499.53,50165,49835
2,13,1.952689271098849,1,0.01,1,1
3,13,2.803816832039514,1,0.01,2,1
100,13,89.43947670998361,63,0.32,70,30
200,13,181.3364712401733,157,0.79,119,81
2000,13,1787.505883087826,1939,9.7,1051,949
10000,13,8953.41720464827,9926,49.63,5029,4971
20000,13,17857.472169183344,19920,99.6,10171,9829
40000,13,35878.306933953216,39915,199.57,19878,20122
60000,13,53713.3158902491,59911,299.55,29949,30051
80000,13,71620.04934767545,79909,399.54,40060,39940
100000,13,89475.36966008513,99907,499.53,50097,49903
2,14,1.70394706197889,1,0.01,2,0
3,14,2.892466977546364,1,0.01,2,1
100,14,87.84213154701214,63,0.32,75,25
200,14,178.23316282940343,157,0.79,129,71
2000,14,1784.2540659513102,1939,9.7,1051,949
10000,14,8919.096410166236,9926,49.63,5082,4918
20000,14,17924.550364704253,19920,99.6,10046,9954
40000,14,35852.05798528784,39915,199.57,19957,20043
60000,14,53714.82572867812,59911,299.55,30006,29994
80000,14,71610.54953787291,79909,399.54,40105,39895
100000,14,89432.36851556755,99907,499.53,50166,49834
2,15,1.3208807995431568,1,0.01,2,0
3,15,2.6335258451063965,1,0.01,3,0
100,15,90.86958023500526,63,0.32,61,39
200,15,178.78586087051684,157,0.79,119,81
2000,15,1769.005160800301,1939,9.7,1069,931
10000,15,8953.324284072603,9926,49.63,5058,4942
20000,15,17931.58955205702,19920,99.6,10062,9938
40000,15,35823.93830386194,39915,199.57,19991,20009
60000,15,53782.64360583912,59911,299.55,29884,30116
80000,15,71493.09168802004,79909,399.54,40201,39799
100000,15,89507.5241720905,99907,499.53,49900,50100
2,16,1.7637053061188026,1,0.01,2,0
3,16,2.7594475614770757,1,0.01,2,1
100,16,88.49440746480961,63,0.32,71,29
200,16,180.03379201794004,157,0.79,117,83
2000,16,1793.9595709348825,1939,9.7,1026,974
10000,16,8954.378981738226,9926,49.63,5060,4940
20000,16,17945.1905679618,19920,99.6,9901,10099
40000,16,35723.89176321351,39915,199.57,20206,19794
60000,16,53672.00039914025,59911,299.55,30155,29845
80000,16,71412.66994979729,79909,399.54,40324,39676
100000,16,89347.32871201272,99907,499.53,50105,49895
2,17,1.4693117394138238,1,0.01,2,0
3,17,2.597468556518067,1,0.01,3,0
100,17,91.61781878734747,63,0.32,66,34
200,17,180.75226293394934,157,0.79,120,80
2000,17,1795.5670115621563,1939,9.7,1017,983
10000,17,8947.57111690107,9926,49.63,5042,4958
20000,17,17905.77555933372,19920,99.6,10053,9947
40000,17,35817.92922285873,39915,199.57,19973,20027
60000,17,53739.67956183175,59911,299.55,30111,29889
80000,17,71604.43802828362,79909,399.54,39932,40068
100000,17,89629.74846975018,99907,499.53,49810,50190
2,18,2.356163139238328,1,0.01,1,1
3,18,2.639420838746501,1,0.01,3,0
100,18,85.22482368373275,63,0.32,77,23
200,18,187.5790380816944,157,0.79,106,94
2000,18,1769.8298380963727,1939,9.7,1072,928
10000,18,8911.113143252358,9926,49.63,5060,4940
20000,18,17967.78902455727,19920,99.6,9981,10019
40000,18,35816.78956485993,39915,199.57,19942,20058
60000,18,53597.517598439896,59911,299.55,30125,29875
80000,18,71686.1104366225,79909,399.54,39986,40014
100000,18,89546.3914171182,99907,499.53,49808,50192
2,19,2.1198417339492854,1,0.01,1,1
3,19,3.1270030652876972,1,0.01,2,1
100,19,90.31028570933785,63,0.32,70,30
200,19,172.38962223104042,157,0.79,128,72
2000,19,1788.7767757913737,1939,9.7,1040,960
10000,19,8938.985292965237,9926,49.63,5079,4921
20000,19,17925.945535728493,19920,99.6,10067,9933
40000,19,35762.47444913349,39915,199.57,20063,19937
60000,19,53667.86496357893,59911,299.55,30116,29884
80000,19,71607.98619396392,79909,399.54,40113,39887
100000,19,89519.33017222334,99907,499.53,49932,50068
2,20,1.7464505010777027,1,0.01,2,0
3,20,2.777559891314736,1,0.01,2,1
100,20,85.67236168132823,63,0.32,76,24
200,20,174.857613410851,157,0.79,124,76
2000,20,1800.9227540665238,1939,9.7,1017,983
10000,20,8930.306250940868,9926,49.63,5025,4975
20000,20,17879.434980124726,19920,99.6,10013,9987
40000,20,35843.21687316728,39915,199.57,20049,19951
60000,20,53755.44465565468,59911,299.55,29970,30030
80000,20,71628.25544138676,79909,399.54,39934,40066
100000,20,89676.7740730585,99907,499.53,49717,50283
2,21,2.01621357559518,1,0.01,1,1
3,21,2.742814941141497,1,0.01,2,1
100,21,87.02930923504827,63,0.32,72,28
200,21,181.11376018502756,157,0.79,119,81
2000,21,1782.6495124730288,1939,9.7,1063,937
10000,21,8953.673717778502,9926,49.63,5015,4985
20000,21,17913.54284047887,19920,99.6,10075,9925
40000,21,35708.228470447815,39915,199.57,20169,19831
60000,21,53502.227870408904,59911,299.55,30306,29694
80000,21,71505.6911533863,79909,399.54,40100,39900
100000,21,89489.79626982573,99907,499.53,50153,49847
2,22,1.5888145929538489,1,0.01,2,0
3,22,2.9399919545661737,1,0.01,2,1
100,22,91.68572982986996,63,0.32,66,34
200,22,177.54699168093498,157,0.79,121,79
2000,22,1795.17199121701,1939,9.7,1028,972
10000,22,8897.51973536754,9926,49.63,5082,4918
20000,22,17824.490368232473,19920,99.6,10117,9883
40000,22,35836.91083943541,39915,199.57,20034,19966
60000,22,53715.115970627194,59911,299.55,30081,29919
80000,22,71507.7001773374,79909,399.54,40299,39701
100000,22,89375.46658971814,99907,499.53,50205,49795
2,23,2.2009629242433224,1,0.01,1,1
3,23,3.3753654887629208,1,0.01,2,1
100,23,86.79176919637541,63,0.32,75,25
200,23,180.99484387462294,157,0.79,126,74
2000,23,1784.0744943458803,1939,9.7,1043,957
10000,23,8950.341502272668,9926,49.63,5015,4985
20000,23,17909.0620604217,19920,99.6,10043,9957
40000,23,35843.076715306626,39915,199.57,20046,19954
60000,23,53780.40458257756,59911,299.55,30054,29946
80000,23,71717.77626489186,79909,399.54,39783,40217
100000,23,89588.21981914835,99907,499.53,50116,49884
2,24,1.8308818184280184,1,0.01,1,1
3,24,2.602268623831712,1,0.01,3,0
100,24,93.643280711885,63,0.32,64,36
200,24,177.6148923131514,157,0.79,124,76
2000,24,1812.887519648698,1939,9.7,988,1012
10000,24,8931.59880482324,9926,49.63,5055,4945
20000,24,17924.613083999975,19920,99.6,9986,10014
40000,24,35764.66534289134,39915,199.57,19903,20097
60000,24,53646.96476392787,59911,299.55,30057,29943
80000,24,71685.16370331569,79909,399.54,39861,40139
100000,24,89494.10212988275,99907,499.53,50170,49830
2,25,2.223300092920116,1,0.01,1,1
3,25,2.9950776599718774,1,0.01,2,1
100,25,87.85866067758238,63,0.32,75,25
200,25,176.5692351365227,157,0.79,128,72
2000,25,1792.440258180966,1939,9.7,1008,992
10000,25,8982.284916790957,9926,49.63,5060,4940
20000,25,17916.907666932344,19920,99.6,9948,10052
40000,25,35808.00505542689,39915,199.57,19986,20014
60000,25,53646.469595987866,59911,299.55,30123,29877
80000,25,71708.13906900481,79909,399.54,39911,40089
100000,25,89389.02096778006,99907,499.53,50124,49876
2,26,1.5275272075071182,1,0.01,2,0
3,26,2.8563724201821428,1,0.01,2,1
100,26,89.49080277575409,63,0.32,66,34
200,26,174.44932179301233,157,0.79,137,63
2000,26,1803.1691210596414,1939,9.7,1019,981
10000,26,8962.237035228498,9926,49.63,5045,4955
20000,26,17868.159078884502,19920,99.6,10084,9916
40000,26,35889.131812999345,39915,199.57,19926,20074
60000,26,53811.004924544206,59911,299.55,29917,30083
80000,26,71546.78696759717,79909,399.54,39960,40040
100000,26,89565.2244379597,99907,499.53,50043,49957
2,27,2.021118109529445,1,0.01,1,1
3,27,2.4208026838477643,1,0.01,3,0
100,27,87.21251356967637,63,0.32,69,31
200,27,176.23062971411073,157,0.79,124,76
2000,27,1805.2733003408775,1939,9.7,1019,981
10000,27,8935.78803934804,9926,49.63,5056,4944
20000,27,17884.11372634384,19920,99.6,10059,9941
40000,27,35838.02643839285,39915,199.57,19985,20015
60000,27,53606.95032799975,59911,299.55,30019,29981
80000,27,71643.97633865927,79909,399.54,40183,39817
100000,27,89449.85281711647,99907,499.53,50068,49932
2,28,2.16267612545835,1,0.01,1,1
3,28,2.71441539242759,1,0.01,2,1
100,28,90.7663335172876,63,0.32,70,30
200,28,180.47791047991623,157,0.79,113,87
2000,28,1786.842918149374,1939,9.7,1016,984
10000,28,8952.823265829451,9926,49.63,5083,4917
20000,28,17986.07000439785,19920,99.6,9981,10019
40000,28,35787.576451681205,39915,199.57,20041,19959
60000,28,53752.16854010514,59911,299.55,29931,30069
80000,28,71558.02913633543,79909,399.54,40012,39988
100000,28,89497.25286522771,99907,499.53,50027,49973
2,29,1.5981594179480596,1,0.01,2,0
3,29,2.9939302591765684,1,0.01,2,1
100,29,89.3385180335112,63,0.32,73,27
200,29,178.05733618923716,157,0.79,125,75
2000,29,1792.2682440243752,1939,9.7,1028,972
10000,29,8970.397497358326,9926,49.63,5011,4989
20000,29,17898.865498768002,19920,99.6,10089,9911
40000,29,35827.95759269687,39915,199.57,20058,19942
60000,29,53645.21400389791,59911,299.55,30034,29966
80000,29,71675.21936442479,79909,399.54,39971,40029
100000,29,89475.30864080707,99907,499.53,50202,49798
2,30,2.1843805633545412,1,0.01,1,1
3,30,3.0848420671094257,1,0.01,2,1
100,30,86.19087262739761,63,0.32,73,27
200,30,179.59254562908245,157,0.79,114,86
2000,30,1762.3783564039002,1939,9.7,1092,908
10000,30,8996.306668324318,9926,49.63,4935,5065
20000,30,17934.41958009635,19920,99.6,10099,9901
40000,30,35777.42223206499,39915,199.57,20059,19941
60000,30,53702.12212002893,59911,299.55,29887,30113
80000,30,71641.57437781656,79909,399.54,40015,39985
100000,30,89416.23291425196,99907,499.53,50134,49866
2,31,1.5566960279372726,1,0.01,2,0
3,31,3.3836272837587997,1,0.01,2,1
100,31,89.98036798978478,63,0.32,69,31
200,31,180.55572917494587,157,0.79,125,75
2000,31,1793.0566497427103,1939,9.7,1046,954
10000,31,8959.246292255615,9926,49.63,5030,4970
20000,31,17866.235924876473,19920,99.6,10042,9958
40000,31,35866.948950849124,39915,199.57,20056,19944
60000,31,53645.5266920806,59911,299.55,30089,29911
80000,31,71668.02326036537,79909,399.54,40007,39993
100000,31,89320.50617552483,99907,499.53,50341,49659
2,32,1.7702313405937633,1,0.01,2,0
3,32,2.840566447798176,1,0.01,2,1
100,32,91.57432423072575,63,0.32,64,36
200,32,179.90247928682047,157,0.79,121,79
2000,32,1792.9533993942362,1939,9.7,1020,980
10000,32,8964.084461255592,9926,49.63,5068,4932
20000,32,17937.112716363186,19920,99.6,10012,9988
40000,32,35882.77482972004,39915,199.57,19907,20093
60000,32,53658.81495772709,59911,299.55,30168,29832
80000,32,71636.02868670244,79909,399.54,39969,40031
100000,32,89411.40358777123,99907,499.53,50248,49752
2,33,1.843356390422711,1,0.01,1,1
3,33,2.861276356527252,1,0.01,2,1
100,33,95.77577811248744,63,0.32,60,40
200,33,173.16622547129722,157,0.79,133,67
2000,33,1810.0755683786745,1939,9.7,993,1007
10000,33,8958.687393558253,9926,49.63,5002,4998
20000,33,17850.7221513011,19920,99.6,10053,9947
40000,33,35838.72621229112,39915,199.57,19994,20006
60000,33,53667.71495867234,59911,299.55,30094,29906
80000,33,71607.98757406551,79909,399.54,40010,39990
100000,33,89668.64510648053,99907,499.53,49981,50019
2,34,1.4175821720508552,1,0.01,2,0
3,34,2.5512373259782666,1,0.01,3,0
100,34,87.62617988849485,63,0.32,68,32
200,34,178.84064740427655,157,0.79,120,80
2000,34,1795.8885099487914,1939,9.7,1053,947
10000,34,8940.598465865009,9926,49.63,5032,4968
20000,34,17938.074995284704,19920,99.6,10032,9968
40000,34,35772.58317528414,39915,199.57,20050,19950
60000,34,53713.08730626825,59911,299.55,30023,29977
80000,34,71793.18032710791,79909,399.54,39560,40440
100000,34,89484.07755790488,99907,499.53,49910,50090
2,35,1.925676665655471,1,0.01,1,1
3,35,2.6514481519370716,1,0.01,3,0
100,35,91.82920726654795,63,0.32,68,32
200,35,185.3411059624322,157,0.79,119,81
2000,35,1822.5310854320244,1939,9.7,981,1019
10000,35,8956.407649292958,9926,49.63,5032,4968
20000,35,17886.01142321034,19920,99.6,9969,10031
40000,35,35659.62183524361,39915,199.57,20132,19868
60000,35,53552.93325258617,59911,299.55,30191,29809
80000,35,71586.31143053384,79909,399.54,39916,40084
100000,35,89524.05431696677,99907,499.53,50171,49829
2,36,1.8372708266920883,1,0.01,1,1
3,36,2.3670036002456945,1,0.01,3,0
100,36,92.30301050918183,63,0.32,71,29
200,36,172.46718271970207,157,0.79,134,66
2000,36,1779.128839898896,1939,9.7,1034,966
10000,36,8950.352504610153,9926,49.63,5024,4976
20000,36,17847.468469408857,19920,99.6,10081,9919
40000,36,35879.54659510837,39915,199.57,19861,20139
60000,36,53733.89591171917,59911,299.55,29916,30084
80000,36,71699.59854653434,79909,399.54,39854,40146
100000,36,89450.52975831776,99907,499.53,50323,49677
2,37,2.0903252201770512,1,0.01,1,1
3,37,2.230310492444879,1,0.01,3,0
100,37,85.5110212826884,63,0.32,70,30
200,37,172.03102714812783,157,0.79,136,64
2000,37,1794.4234534324398,1939,9.7,1013,987
10000,37,8961.295606188798,9926,49.63,5015,4985
20000,37,17858.45159237995,19920,99.6,10177,9823
40000,37,35827.05089136987,39915,199.57,19918,20082
60000,37,53677.18569327401,59911,299.55,30183,29817
80000,37,71633.44918293663,79909,399.54,39948,40052
100000,37,89479.79408918704,99907,499.53,50100,49900
2,38,2.2646905341855725,1,0.01,1,1
3,38,2.375005702683647,1,0.01,3,0
100,38,93.04310231428728,63,0.32,63,37
200,38,174.71606900288575,157,0.79,124,76
2000,38,1799.162879430094,1939,9.7,1013,987
10000,38,8954.349990944294,9926,49.63,5069,4931
20000,38,17891.730245869996,19920,99.6,10069,9931
40000,38,35710.72088511524,39915,199.57,20008,19992
60000,38,53622.63084751242,59911,299.55,30096,29904
80000,38,71566.74485201895,79909,399.54,40084,39916
100000,38,89609.89757638353,99907,499.53,50019,49981
2,39,1.7534502982192972,1,0.01,2,0
3,39,2.7497245175597484,1,0.01,2,1
100,39,91.05705695695454,63,0.32,67,33
200,39,176.0373508442985,157,0.79,129,71
2000,39,1810.350615226714,1939,9.7,1008,992
10000,39,8946.821629155183,9926,49.63,5037,4963
20000,39,17871.883504922498,19920,99.6,10059,9941
40000,39,35813.526004444226,39915,199.57,20014,19986
60000,39,53620.18741930776,59911,299.55,30144,29856
80000,39,71428.41989798199,79909,399.54,40145,39855
100000,39,89385.20165315727,99907,499.53,50182,49818
2,40,2.2322144538087456,1,0.01,1,1
3,40,2.6122457129060526,1,0.01,3,0
100,40,89.02235721703978,63,0.32,68,32
200,40,178.19766769889273,157,0.79,126,74
2000,40,1810.9358389757062,1939,9.7,990,1010
10000,40,8991.03406547716,9926,49.63,4992,5008
20000,40,17904.546506307415,19920,99.6,10046,9954
40000,40,35801.26652113562,39915,199.57,20030,19970
60000,40,53696.734446592716,59911,299.55,30004,29996
80000,40,71959.70722526706,79909,399.54,39752,40248
100000,40,89438.01914116733,99907,499.53,50233,49767
2,41,1.6528571270608994,1,0.01,2,0
3,41,2.5175215659836354,1,0.01,3,0
100,41,89.27692154326786,63,0.32,69,31
200,41,175.86853401812274,157,0.79,126,74
2000,41,1806.8968667076133,1939,9.7,1014,986
10000,41,8924.23051077534,9926,49.63,5092,4908
20000,41,17926.981610301536,19920,99.6,10021,9979
40000,41,35757.009039321216,39915,199.57,20039,19961
60000,41,53663.10104279208,59911,299.55,30107,29893
80000,41,71685.14047698851,79909,399.54,39863,40137
100000,41,89552.34883865043,99907,499.53,50018,49982
2,42,1.5249735461351053,1,0.01,2,0
3,42,2.537791557493136,1,0.01,3,0
100,42,85.48224672395926,63,0.32,75,25
200,42,184.10100971195672,157,0.79,112,88
2000,42,1827.1676157754748,1939,9.7,988,1012
10000,42,8999.907798582055,9926,49.63,4948,5052
20000,42,17874.39571356295,19920,99.6,10079,9921
40000,42,35832.14549134949,39915,199.57,19998,20002
60000,42,53714.47536495735,59911,299.55,30040,29960
80000,42,71585.80509454788,79909,399.54,40069,39931
100000,42,89373.92769324651,99907,499.53,50434,49566
2,43,2.4721932811233844,1,0.01,1,1
3,43,3.0029691847692894,1,0.01,2,1
100,43,89.78258799294326,63,0.32,71,29
200,43,180.71261856263595,157,0.79,118,82
2000,43,1776.6553329937126,1939,9.7,1079,921
10000,43,8939.953305934258,9926,49.63,5026,4974
20000,43,17896.777079381198,19920,99.6,10097,9903
40000,43,35804.228095475264,39915,199.57,20120,19880
60000,43,53638.89936793007,59911,299.55,30085,29915
80000,43,71723.98038838524,79909,399.54,39946,40054
100000,43,89439.87671328677,99907,499.53,50392,49608
2,44,2.1781709481634355,1,0.01,1,1
3,44,3.133628850717113,1,0.01,2,1
100,44,93.48062805172482,63,0.32,61,39
200,44,176.3732439793249,157,0.79,126,74
2000,44,1782.5110867714188,1939,9.7,1039,961
10000,44,8972.731981381148,9926,49.63,5007,4993
20000,44,17867.97622088202,19920,99.6,10135,9865
40000,44,35755.90099807463,39915,199.57,20048,19952
60000,44,53720.008651812444,59911,299.55,29993,30007
80000,44,71661.87799107235,79909,399.54,39993,40007
100000,44,89364.33483316342,99907,499.53,50290,49710
2,45,1.1183399063538675,1,0.01,2,0
3,45,2.740559465330659,1,0.01,2,1
100,45,92.38580874993879,63,0.32,62,38
200,45,179.3375212965754,157,0.79,118,82
2000,45,1787.9492602954344,1939,9.7,1017,983
10000,45,8919.437331992063,9926,49.63,5056,4944
20000,45,17939.443554404355,19920,99.6,9951,10049
40000,45,35751.41758185662,39915,199.57,20011,19989
60000,45,53770.018046891964,59911,299.55,29856,30144
80000,45,71621.63125422827,79909,399.54,39861,40139
100000,45,89527.81241809386,99907,499.53,49982,50018
2,46,1.8774112185096141,1,0.01,1,1
3,46,2.8598098171583826,1,0.01,2,1
100,46,88.51711843636143,63,0.32,67,33
200,46,174.34201429030182,157,0.79,127,73
2000,46,1782.2476030288808,1939,9.7,1032,968
10000,46,8956.52871839688,9926,49.63,5015,4985
20000,46,17900.670163905757,19920,99.6,9990,10010
40000,46,35859.412947545534,39915,199.57,20049,19951
60000,46,53763.66734667223,59911,299.55,30041,29959
80000,46,71578.90038156764,79909,399.54,39888,40112
100000,46,89543.45176559429,99907,499.53,49993,50007
2,47,1.6486851442976183,1,0.01,2,0
3,47,3.4106392433329478,1,0.01,2,1
100,47,87.64296358739868,63,0.32,72,28
200,47,179.46425185497975,157,0.79,120,80
2000,47,1799.241816813787,1939,9.7,1025,975
10000,47,8935.555065714563,9926,49.63,5070,4930
20000,47,17930.798200030753,19920,99.6,10026,9974
40000,47,35785.34403349748,39915,199.57,20139,19861
60000,47,53762.58516756092,59911,299.55,29942,30058
80000,47,71524.2342694035,79909,399.54,40135,39865
100000,47,89464.69525296077,99907,499.53,49976,50024
2,48,1.321693914281719,1,0.01,2,0
3,48,2.5350698403668943,1,0.01,3,0
100,48,84.75872857092696,63,0.32,74,26
200,48,178.20242841176727,157,0.79,122,78
2000,48,1786.6044265476796,1939,9.7,1011,989
10000,48,8997.584559034723,9926,49.63,4992,5008
20000,48,17853.406270993164,19920,99.6,10122,9878
40000,48,35770.57963726605,39915,199.57,20047,19953
60000,48,53703.881988001325,59911,299.55,29976,30024
80000,48,71550.21134157675,79909,399.54,40022,39978
100000,48,89523.0297927436,99907,499.53,50025,49975
2,49,1.9116375147087954,1,0.01,1,1
3,49,2.321551756318404,1,0.01,3,0
100,49,89.06067152904485,63,0.32,65,35
200,49,179.79465338749097,157,0.79,116,84
2000,49,1794.0902612080922,1939,9.7,1015,985
10000,49,8986.453042796657,9926,49.63,5023,4977
20000,49,17963.47732316448,19920,99.6,10013,9987
40000,49,35884.41253675753,39915,199.57,19946,20054
60000,49,53670.52594931178,59911,299.55,30072,29928
80000,49,71555.33274584118,79909,399.54,40102,39898
100000,49,89381.11670799801,99907,499.53,50156,49844
2,50,1.991301979529145,1,0.01,1,1
3,50,2.9525186920142836,1,0.01,2,1
100,50,94.36956459047153,63,0.32,63,37
200,50,170.07746497719606,157,0.79,131,69
2000,50,1787.8056811811061,1939,9.7,1030,970
10000,50,8985.936667730382,9926,49.63,4989,5011
20000,50,17919.93647777095,19920,99.6,9942,10058
40000,50,35840.935973901185,39915,199.57,19931,20069
60000,50,53673.41294900263,59911,299.55,30020,29980
80000,50,71521.97100794414,79909,399.54,40164,39836
100000,50,89537.8475459905,99907,499.53,50080,49920
2,51,1.5341381446434998,1,0.01,2,0
3,51,2.461741547527811,1,0.01,3,0
100,51,87.50397483049748,63,0.32,73,27
200,51,177.91004706782974,157,0.79,123,77
2000,51,1798.9043750235157,1939,9.7,997,1003
10000,51,8946.87288900721,9926,49.63,5081,4919
20000,51,17939.37747590308,19920,99.6,9918,10082
40000,51,35927.31448672085,39915,199.57,19872,20128
60000,51,53653.872267529456,59911,299.55,30050,29950
80000,51,71563.44050599498,79909,399.54,40270,39730
100000,51,89460.90748151226,99907,499.53,50261,49739
2,52,2.054252969772766,1,0.01,1,1
3,52,2.1194378317713465,1,0.01,3,0
100,52,86.67204008827996,63,0.32,73,27
200,52,179.55543849984997,157,0.79,119,81
2000,52,1780.4769348456907,1939,9.7,1024,976
10000,52,8938.442805994675,9926,49.63,5086,4914
20000,52,17931.609457038307,19920,99.6,10043,9957
40000,52,35801.17003384119,39915,199.57,20012,19988
60000,52,53606.79216845239,59911,299.55,30178,29822
80000,52,71564.65930457335,79909,399.54,39926,40074
100000,52,89372.4385100355,99907,499.53,50451,49549
2,53,1.1907784055429151,1,0.01,2,0
3,53,2.6904028081272084,1,0.01,3,0
100,53,88.90332432109592,63,0.32,70,30
200,53,175.73023154185705,157,0.79,130,70
2000,53,1799.741170426592,1939,9.7,1009,991
10000,53,8981.50297025845,9926,49.63,4982,5018
20000,53,17915.28855032089,19920,99.6,10037,9963
40000,53,35844.61784226891,39915,199.57,19906,20094
60000,53,53774.30203611131,59911,299.55,29945,30055
80000,53,71511.89028887791,79909,399.54,40191,39809
100000,53,89517.98199895481,99907,499.53,49981,50019
2,54,1.947485794199466,1,0.01,1,1
3,54,2.8369306969220074,1,0.01,2,1
100,54,91.76255102061614,63,0.32,63,37
200,54,178.01368602400632,157,0.79,125,75
2000,54,1804.1847969845655,1939,9.7,1019,981
10000,54,8969.18399211391,9926,49.63,5022,4978
20000,54,17823.34376179975,19920,99.6,10098,9902
40000,54,35739.12972341871,39915,199.57,20118,19882
60000,54,53604.17095790053,59911,299.55,30235,29765
80000,54,71455.50612027144,79909,399.54,40227,39773
100000,54,89567.54759736118,99907,499.53,50171,49829
2,55,2.2475743098553105,1,0.01,1,1
3,55,3.0409407468715104,1,0.01,2,1
100,55,88.4598751177267,63,0.32,71,29
200,55,180.93488624538807,157,0.79,119,81
2000,55,1813.9510912035767,1939,9.7,1026,974
10000,55,8977.913744439196,9926,49.63,5018,4982
20000,55,17921.920211096287,19920,99.6,9938,10062
40000,55,35859.788298409854,39915,199.57,19976,20024
60000,55,53727.89696342056,59911,299.55,29969,30031
80000,55,71579.5391218628,79909,399.54,40209,39791
100000,55,89624.30598399529,99907,499.53,49910,50090
2,56,2.080176074375353,1,0.01,1,1
3,56,2.8239804893030227,1,0.01,2,1
100,56,91.32163502166243,63,0.32,66,34
200,56,178.34463729986405,157,0.79,126,74
2000,56,1813.5656413711793,1939,9.7,997,1003
10000,56,8979.85822985702,9926,49.63,5033,4967
20000,56,17844.70500411113,19920,99.6,10153,9847
40000,56,35742.17386834373,39915,199.57,20010,19990
60000,56,53721.949168459134,59911,299.55,30063,29937
80000,56,71682.43768564585,79909,399.54,40049,39951
100000,56,89506.51374218591,99907,499.53,50099,49901
2,57,1.7422152178874604,1,0.01,2,0
3,57,2.8672445970585883,1,0.01,2,1
100,57,87.47206444024114,63,0.32,69,31
200,57,182.1818167993888,157,0.79,122,78
2000,57,1802.8994005422128,1939,9.7,1018,982
10000,57,8958.904365464672,9926,49.63,5038,4962
20000,57,17852.627805434982,19920,99.6,10077,9923
40000,57,35834.05725948104,39915,199.57,20046,19954
60000,57,53705.783658320026,59911,299.55,30107,29893
80000,57,71562.85158195796,79909,399.54,40063,39937
100000,57,89497.55227031156,99907,499.53,50086,49914
2,58,1.1492098828235648,1,0.01,2,0
3,58,2.8553829876007826,1,0.01,2,1
100,58,90.88793009830593,63,0.32,66,34
200,58,181.23054107293092,157,0.79,119,81
2000,58,1807.210684579603,1939,9.7,992,1008
10000,58,8952.416121262402,9926,49.63,5032,4968
20000,58,17989.7920749746,19920,99.6,9963,10037
40000,58,35794.476289419596,39915,199.57,20033,19967
60000,58,53661.40723740298,59911,299.55,30055,29945
80000,58,71610.79913440537,79909,399.54,39995,40005
100000,58,89542.82409429192,99907,499.53,49842,50158
2,59,1.6948400253143268,1,0.01,2,0
3,59,2.394313892630443,1,0.01,3,0
100,59,92.49513987887377,63,0.32,68,32
200,59,183.77443562879517,157,0.79,108,92
2000,59,1794.883201311796,1939,9.7,1016,984
10000,59,8935.967080923327,9926,49.63,5055,4945
20000,59,17910.3524936523,19920,99.6,10039,9961
40000,59,35756.67748704227,39915,199.57,20088,19912
60000,59,53673.34657590734,59911,299.55,30146,29854
80000,59,71544.35919991024,79909,399.54,40031,39969
100000,59,89449.29090661745,99907,499.53,50133,49867
2,60,1.4331183033761892,1,0.01,2,0
3,60,2.8928099916271184,1,0.01,2,1
100,60,92.87672566900102,63,0.32,63,37
200,60,181.9162227087999,157,0.79,114,86
2000,60,1799.485992862707,1939,9.7,1038,962
10000,60,8944.794554856955,9926,49.63,5018,4982
20000,60,17848.121391312565,19920,99.6,10150,9850
40000,60,35882.91122708365,39915,199.57,19848,20152
60000,60,53674.75362282511,59911,299.55,30077,29923
80000,60,71541.29804925574,79909,399.54,40248,39752
100000,60,89399.54824258665,99907,499.53,50102,49898
2,61,2.0095668120823444,1,0.01,1,1
3,61,2.6107442070296387,1,0.01,3,0
100,61,91.14735167997695,63,0.32,66,34
200,61,176.6179401584689,157,0.79,129,71
2000,61,1800.715101616488,1939,9.7,1004,996
10000,61,8981.425340952428,9926,49.63,5009,4991
20000,61,17891.645959575733,19920,99.6,10094,9906
40000,61,35757.867596304284,39915,199.57,20162,19838
60000,61,53564.58986626635,59911,299.55,30252,29748
80000,61,71594.77247787536,79909,399.54,39912,40088
100000,61,89513.76457507047,99907,499.53,50034,49966
2,62,2.082615825674451,1,0.01,1,1
3,62,2.4315930685207645,1,0.01,3,0
100,62,91.57399281073097,63,0.32,68,32
200,62,178.84427493302172,157,0.79,120,80
2000,62,1787.0409632370474,1939,9.7,1038,962
10000,62,8912.899826899742,9926,49.63,5107,4893
20000,62,17841.170492170848,19920,99.6,10067,9933
40000,62,35824.88866690336,39915,199.57,20049,19951
60000,62,53707.05299471891,59911,299.55,30064,29936
80000,62,71735.6710197269,79909,399.54,39823,40177
100000,62,89450.1872104228,99907,499.53,50068,49932
2,63,2.1804941802748132,1,0.01,1,1
3,63,2.8378234116606897,1,0.01,2,1
100,63,89.53407927479635,63,0.32,66,34
200,63,176.49020676619315,157,0.79,121,79
2000,63,1784.7739619151862,1939,9.7,1064,936
10000,63,8869.831943307485,9926,49.63,5164,4836
20000,63,17897.31136415166,19920,99.6,9994,10006
40000,63,35652.372092120095,39915,199.57,20178,19822
60000,63,53723.27218930135,59911,299.55,30167,29833
80000,63,71703.47798358653,79909,399.54,39885,40115
100000,63,89430.75997597378,99907,499.53,50139,49861
2,64,2.391774107196141,1,0.01,1,1
3,64,2.887253194591964,1,0.01,2,1
100,64,89.8649268572325,63,0.32,68,32
200,64,186.8544855911287,157,0.79,106,94
2000,64,1775.2945828724949,1939,9.7,1070,930
10000,64,8953.473498924639,9926,49.63,5024,4976
20000,64,17903.667025351988,19920,99.6,9970,10030
40000,64,35821.745971824654,39915,199.57,20157,19843
60000,64,53922.511294231794,59911,299.55,29689,30311
80000,64,71608.19947482915,79909,399.54,40060,39940
100000,64,89328.08877241124,99907,499.53,50235,49765
2,65,2.068251479949177,1,0.01,1,1
3,65,2.251967272756584,1,0.01,3,0
100,65,89.8504192647978,63,0.32,72,28
200,65,181.31738311639137,157,0.79,123,77
2000,65,1817.5820298982271,1939,9.7,1008,992
10000,65,8935.645463839723,9926,49.63,5038,4962
20000,65,17952.762217920423,19920,99.6,10002,9998
40000,65,35773.02798663909,39915,199.57,20074,19926
60000,65,53636.12895955606,59911,299.55,30240,29760
80000,65,71520.19063442142,79909,399.54,40128,39872
100000,65,89567.77320313978,99907,499.53,49976,50024
2,66,1.8154831253267605,1,0.01,1,1
3,66,2.447538686310888,1,0.01,3,0
100,66,92.30989695411506,63,0.32,67,33
200,66,176.34893653844563,157,0.79,127,73
2000,66,1815.9046453692467,1939,9.7,1011,989
10000,66,8960.485787404925,9926,49.63,5059,4941
20000,66,17881.38324010058,19920,99.6,10103,9897
40000,66,35724.17508812429,39915,199.57,20212,19788
60000,66,53663.20655889942,59911,299.55,30129,29871
80000,66,71585.3464420604,79909,399.54,40043,39957
100000,66,89571.86328594405,99907,499.53,49823,50177
2,67,1.0758553224255203,1,0.01,2,0
3,67,2.6079663852427544,1,0.01,3,0
100,67,86.83622592086888,63,0.32,75,25
200,67,183.01170723925813,157,0.79,122,78
2000,67,1778.016318290666,1939,9.7,1041,959
10000,67,8941.920698383456,9926,49.63,5063,4937
20000,67,17896.12127807893,19920,99.6,10087,9913
40000,67,35827.99357237966,39915,199.57,19969,20031
60000,67,53673.80097521772,59911,299.55,29983,30017
80000,67,71705.40659445552,79909,399.54,39852,40148
100000,67,89519.7321601682,99907,499.53,49784,50216
2,68,2.1295558058894217,1,0.01,1,1
3,68,2.3409936154234345,1,0.01,3,0
100,68,88.61181953390663,63,0.32,69,31
200,68,173.57899069861304,157,0.79,132,68
2000,68,1805.7664172336074,1939,9.7,999,1001
10000,68,8968.913043241053,9926,49.63,5016,4984
20000,68,17906.67829482464,19920,99.6,10020,9980
40000,68,35791.00487514565,39915,199.57,20030,19970
60000,68,53642.27434236913,59911,299.55,29950,30050
80000,68,71586.04271017908,79909,399.54,40108,39892
100000,68,89621.88508706096,99907,499.53,49798,50202
2,69,2.259421876299644,1,0.01,1,1
3,69,1.935876599419443,1,0.01,3,0
100,69,89.52410964884258,63,0.32,69,31
200,69,179.9015320127506,157,0.79,122,78
2000,69,1799.4884264649238,1939,9.7,1027,973
10000,69,8959.924653193037,9926,49.63,5007,4993
20000,69,17935.77469471245,19920,99.6,9987,10013
40000,69,35782.6142556335,39915,199.57,20075,19925
60000,69,53740.739003793475,59911,299.55,29973,30027
80000,69,71630.44015467176,79909,399.54,40117,39883
100000,69,89447.56845840065,99907,499.53,50216,49784
2,70,2.313119448905296,1,0.01,1,1
3,70,2.843879723711926,1,0.01,2,1
100,70,92.30049795428879,63,0.32,62,38
200,70,186.23281032525603,157,0.79,104,96
2000,70,1788.9810012206583,1939,9.7,1022,978
10000,70,9009.607420057191,9926,49.63,4975,5025
20000,70,17980.96450704107,19920,99.6,9949,10051
40000,70,35773.98098824865,39915,199.57,20088,19912
60000,70,53530.409981340046,59911,299.55,30348,29652
80000,70,71500.0469004728,79909,399.54,40001,39999
100000,70,89363.5205177866,99907,499.53,50222,49778
2,71,1.7867675502934988,1,0.01,2,0
3,71,2.8535561023391858,1,0.01,2,1
100,71,88.6876726329252,63,0.32,67,33
200,71,183.29923787838598,157,0.79,112,88
2000,71,1793.6312536691676,1939,9.7,1004,996
10000,71,8979.899960282917,9926,49.63,4992,5008
20000,71,17912.741410768438,19920,99.6,10051,9949
40000,71,35844.86293250457,39915,199.57,19965,20035
60000,71,53650.386628376626,59911,299.55,30039,29961
80000,71,71657.38942916748,79909,399.54,39844,40156
100000,71,89468.82079154202,99907,499.53,50023,49977
2,72,1.709560956632099,1,0.01,2,0
3,72,2.5128780646265048,1,0.01,3,0
100,72,84.56293615698138,63,0.32,78,22
200,72,181.2452894868223,157,0.79,119,81
2000,72,1765.0403052440208,1939,9.7,1071,929
10000,72,8925.288981373795,9926,49.63,5069,4931
20000,72,17882.174320952192,19920,99.6,10098,9902
40000,72,35763.31826786884,39915,199.57,20076,19924
60000,72,53696.18360985618,59911,299.55,30038,29962
80000,72,71615.94154463032,79909,399.54,40063,39937
100000,72,89481.5341509785,99907,499.53,50051,49949
2,73,1.7366806315994094,1,0.01,2,0
3,73,2.6378025573269808,1,0.01,3,0
100,73,91.45028078191022,63,0.32,68,32
200,73,181.4639329666781,157,0.79,120,80
2000,73,1785.6190116804949,1939,9.7,1026,974
10000,73,8939.018787387566,9926,49.63,5069,4931
20000,73,17929.181697477736,19920,99.6,9979,10021
40000,73,35777.48785460913,39915,199.57,20082,19918
60000,73,53644.74813353438,59911,299.55,30119,29881
80000,73,71482.60848850284,79909,399.54,40182,39818
100000,73,89651.26857016784,99907,499.53,49761,50239
2,74,1.1052709332313218,1,0.01,2,0
3,74,2.5696619219654435,1,0.01,3,0
100,74,87.14689682454276,63,0.32,74,26
200,74,171.4079093095821,157,0.79,131,69
2000,74,1764.9886579500485,1939,9.7,1050,950
10000,74,8906.975605776854,9926,49.63,5082,4918
20000,74,18007.996482253617,19920,99.6,9886,10114
40000,74,35843.092623190554,39915,199.57,20045,19955
60000,74,53686.76555186235,59911,299.55,29944,30056
80000,74,71625.55452251331,79909,399.54,40120,39880
100000,74,89551.20796742993,99907,499.53,49983,50017
2,75,1.5594470908452647,1,0.01,2,0
3,75,2.6216305728399516,1,0.01,3,0
100,75,92.23749411450885,63,0.32,65,35
200,75,184.10374747875775,157,0.79,119,81
2000,75,1793.268341606422,1939,9.7,1019,981
10000,75,8963.96227509466,9926,49.63,4982,5018
20000,75,17920.014151908068,19920,99.6,9933,10067
40000,75,35741.113588230146,39915,199.57,20115,19885
60000,75,53571.949022397675,59911,299.55,30313,29687
80000,75,71510.89080795797,79909,399.54,40283,39717
100000,75,89491.65417518483,99907,499.53,50007,49993
2,76,1.2701607155688812,1,0.01,2,0
3,76,2.7920104663283047,1,0.01,2,1
100,76,88.2592798533535,63,0.32,67,33
200,76,177.53284257698553,157,0.79,120,80
2000,76,1795.4821212581019,1939,9.7,1021,979
10000,76,8899.415483761784,9926,49.63,5092,4908
20000,76,17887.408582046988,19920,99.6,10124,9876
40000,76,35758.685167331045,39915,199.57,20097,19903
60000,76,53693.53358934753,59911,299.55,30160,29840
80000,76,71547.59852622564,79909,399.54,40118,39882
100000,76,89437.70351898108,99907,499.53,50324,49676
2,77,1.652231869445488,1,0.01,2,0
3,77,2.379452173893966,1,0.01,3,0
100,77,88.42112085799572,63,0.32,71,29
200,77,180.56115443517106,157,0.79,117,83
2000,77,1792.8093662665024,1939,9.7,1014,986
10000,77,8956.948497400641,9926,49.63,4992,5008
20000,77,17974.299566089325,19920,99.6,9949,10051
40000,77,35743.757063813326,39915,199.57,20069,19931
60000,77,53702.59949001014,59911,299.55,30084,29916
80000,77,71466.07739661206,79909,399.54,40365,39635
100000,77,89421.10598993023,99907,499.53,50212,49788
2,78,2.1973701133836983,1,0.01,1,1
3,78,2.7309054280138683,1,0.01,2,1
100,78,87.96174365167514,63,0.32,71,29
200,78,182.35911305092412,157,0.79,116,84
2000,78,1802.9634896094954,1939,9.7,987,1013
10000,78,8961.42704604317,9926,49.63,5024,4976
20000,78,17823.51152951309,19920,99.6,10094,9906
40000,78,35834.303731653265,39915,199.57,19863,20137
60000,78,53745.39953156663,59911,299.55,29915,30085
80000,78,71567.2744847496,79909,399.54,40038,39962
100000,78,89509.93372757395,99907,499.53,49879,50121
2,79,2.0487986802201883,1,0.01,1,1
3,79,2.4061014020924536,1,0.01,3,0
100,79,90.10736016968109,63,0.32,70,30
200,79,174.59035729787146,157,0.79,131,69
2000,79,1790.747117058895,1939,9.7,1032,968
10000,79,8922.948290026025,9926,49.63,5089,4911
20000,79,17860.37670332184,19920,99.6,10159,9841
40000,79,35811.264549207706,39915,199.57,20018,19982
60000,79,53638.79746913286,59911,299.55,30193,29807
80000,79,71631.02950873363,79909,399.54,40057,39943
100000,79,89644.7876343853,99907,499.53,49813,50187
2,80,1.3224703155317288,1,0.01,2,0
3,80,2.5046439721505043,1,0.01,3,0
100,80,91.00997761496983,63,0.32,65,35
200,80,179.6269000683133,157,0.79,120,80
2000,80,1790.2206113940754,1939,9.7,1030,970
10000,80,8964.078491960932,9926,49.63,5041,4959
20000,80,17881.06464170717,19920,99.6,10087,9913
40000,80,35751.505457745785,39915,199.57,20055,19945
60000,80,53637.43497649569,59911,299.55,30227,29773
80000,80,71534.65860630109,79909,399.54,40024,39976
100000,80,89471.86074061811,99907,499.53,50201,49799
2,81,1.537036214452736,1,0.01,2,0
3,81,2.6091651255456823,1,0.01,3,0
100,81,91.83657827630779,63,0.32,69,31
200,81,184.60243506216642,157,0.79,110,90
2000,81,1794.3804317753813,1939,9.7,990,1010
10000,81,8955.109299641437,9926,49.63,5021,4979
20000,81,17862.98427967807,19920,99.6,10074,9926
40000,81,35852.012727780515,39915,199.57,20008,19992
60000,81,53599.494655610186,59911,299.55,30164,29836
80000,81,71746.92206769121,79909,399.54,39918,40082
100000,81,89515.42160402506,99907,499.53,50032,49968
2,82,2.0495785095846415,1,0.01,1,1
3,82,2.678099204784749,1,0.01,3,0
100,82,90.76092629056461,63,0.32,69,31
200,82,177.23730640615864,157,0.79,121,79
2000,82,1801.6422276749531,1939,9.7,1000,1000
10000,82,8946.917178059868,9926,49.63,5050,4950
20000,82,17871.9311890567,19920,99.6,10091,9909
40000,82,35726.80856376521,39915,199.57,20107,19893
60000,82,53579.94789588521,59911,299.55,30328,29672
80000,82,71574.71456893178,79909,399.54,40141,39859
100000,82,89241.73314980094,99907,499.53,50372,49628
2,83,2.113360918873195,1,0.01,1,1
3,83,3.0317860980879723,1,0.01,2,1
100,83,90.48816517490111,63,0.32,67,33
200,83,182.8906322988261,157,0.79,121,79
2000,83,1769.1249786114813,1939,9.7,1038,962
10000,83,8966.544244311872,9926,49.63,4981,5019
20000,83,17901.076876087725,19920,99.6,10063,9937
40000,83,35708.39673122161,39915,199.57,20116,19884
60000,83,53721.43619521502,59911,299.55,30098,29902
80000,83,71627.97810052859,79909,399.54,40058,39942
100000,83,89540.63879148083,99907,499.53,50214,49786
2,84,1.984935703055227,1,0.01,1,1
3,84,2.8037708010920297,1,0.01,2,1
100,84,89.41686251721988,63,0.32,72,28
200,84,173.38875347096814,157,0.79,132,68
2000,84,1772.7607413484898,1939,9.7,1029,971
10000,84,8915.49309427834,9926,49.63,5050,4950
20000,84,17932.282619950543,19920,99.6,10037,9963
40000,84,35855.330071217904,39915,199.57,19898,20102
60000,84,53598.314433951884,59911,299.55,30123,29877
80000,84,71650.64495908046,79909,399.54,40046,39954
100000,84,89610.21174487259,99907,499.53,49846,50154
2,85,1.9681073581451058,1,0.01,1,1
3,85,2.7609836358898687,1,0.01,2,1
100,85,86.00139211278781,63,0.32,75,25
200,85,182.4229525612537,157,0.79,109,91
2000,85,1801.9708568164876,1939,9.7,1004,996
10000,85,8924.243069834038,9926,49.63,5072,4928
20000,85,17869.900602383448,19920,99.6,10083,9917
40000,85,35792.93617780293,39915,199.57,19988,20012
60000,85,53661.22640556839,59911,299.55,30063,29937
80000,85,71648.64313287674,79909,399.54,40029,39971
100000,85,89533.91557267623,99907,499.53,50241,49759
2,86,1.4833746016547071,1,0.01,2,0
3,86,2.446864335848084,1,0.01,3,0
100,86,92.22948474645366,63,0.32,66,34
200,86,182.5596293554867,157,0.79,123,77
2000,86,1763.1122991309035,1939,9.7,1061,939
10000,86,8891.212282511031,9926,49.63,5095,4905
20000,86,17832.62518680092,19920,99.6,10208,9792
40000,86,35867.61829419252,39915,199.57,20014,19986
60000,86,53623.63546373008,59911,299.55,30124,29876
80000,86,71599.11403257232,79909,399.54,40119,39881
100000,86,89562.13821192141,99907,499.53,49967,50033
2,87,1.7460194533497835,1,0.01,2,0
3,87,1.9507218280607352,1,0.01,3,0
100,87,88.94628652581217,63,0.32,67,33
200,87,179.7164652933159,157,0.79,122,78
2000,87,1787.05875265116,1939,9.7,1033,967
10000,87,8979.684820077931,9926,49.63,5005,4995
20000,87,17845.760990724808,19920,99.6,10108,9892
40000,87,35818.78211186963,39915,199.57,19986,20014
60000,87,53819.31226650167,59911,299.55,29922,30078
80000,87,71577.44041419507,79909,399.54,40023,39977
100000,87,89545.53606084952,99907,499.53,49915,50085
2,88,1.4924466790797148,1,0.01,2,0
3,88,1.9691955838839252,1,0.01,3,0
100,88,93.5098401569936,63,0.32,62,38
200,88,174.14023221724287,157,0.79,126,74
2000,88,1768.4833945538894,1939,9.7,1068,932
10000,88,8948.437091162163,9926,49.63,5038,4962
20000,88,17825.910747400798,19920,99.6,10113,9887
40000,88,35846.08868642662,39915,199.57,19981,20019
60000,88,53748.20894829364,59911,299.55,29893,30107
80000,88,71571.02577146208,79909,399.54,40152,39848
100000,88,89529.72659512484,99907,499.53,49797,50203
2,89,1.9251042302013506,1,0.01,1,1
3,89,2.8107151191123783,1,0.01,2,1
100,89,91.13176268615231,63,0.32,66,34
200,89,176.96166121428521,157,0.79,131,69
2000,89,1802.3299827920218,1939,9.7,1013,987
10000,89,8933.870131558291,9926,49.63,5011,4989
20000,89,17877.985967625365,19920,99.6,10052,9948
40000,89,35688.33257108366,39915,199.57,20161,19839
60000,89,53738.40189130723,59911,299.55,30102,29898
80000,89,71573.28845045166,79909,399.54,40090,39910
100000,89,89192.80228107618,99907,499.53,50529,49471
2,90,1.7910095540570874,1,0.01,2,0
3,90,2.8133765046219095,1,0.01,2,1
100,90,87.42234619169443,63,0.32,73,27
200,90,176.931562382439,157,0.79,127,73
2000,90,1768.8200967218845,1939,9.7,1044,956
10000,90,8935.149564824265,9926,49.63,5095,4905
20000,90,17954.220549810907,19920,99.6,9994,10006
40000,90,35755.867313020346,39915,199.57,20142,19858
60000,90,53759.653039740195,59911,299.55,29903,30097
80000,90,71497.7279966576,79909,399.54,40256,39744
100000,90,89670.69940229693,99907,499.53,49896,50104
2,91,1.5666290637361455,1,0.01,2,0
3,91,2.796883407402918,1,0.01,2,1
100,91,87.54203756309384,63,0.32,72,28
200,91,180.7206938042859,157,0.79,123,77
2000,91,1769.4466445478188,1939,9.7,1042,958
10000,91,8985.780211457002,9926,49.63,5001,4999
20000,91,17957.116509777843,19920,99.6,10008,9992
40000,91,35836.472941090055,39915,199.57,20144,19856
60000,91,53719.01621088233,59911,299.55,30019,29981
80000,91,71652.98308538039,79909,399.54,39922,40078
100000,91,89556.60376946286,99907,499.53,50006,49994
2,92,2.0737582182729954,1,0.01,1,1
3,92,2.7060659040738297,1,0.01,2,1
100,92,90.3429602185345,63,0.32,71,29
200,92,182.4383147404461,157,0.79,119,81
2000,92,1772.9935759694802,1939,9.7,1053,947
10000,92,9030.210725660841,9926,49.63,4909,5091
20000,92,18004.686563190717,19920,99.6,9920,10080
40000,92,35791.151526432994,39915,199.57,20088,19912
60000,92,53756.500745390804,59911,299.55,29965,30035
80000,92,71586.27408681947,79909,399.54,40140,39860
100000,92,89579.12132368184,99907,499.53,49887,50113
2,93,1.6307874168647545,1,0.01,2,0
3,93,2.452475038438599,1,0.01,3,0
100,93,87.2726434249489,63,0.32,70,30
200,93,175.4726152335859,157,0.79,126,74
2000,93,1802.4895007258367,1939,9.7,1016,984
10000,93,8956.241635934832,9926,49.63,4983,5017
20000,93,17902.82375921911,19920,99.6,10008,9992
40000,93,35747.22806512052,39915,199.57,20079,19921
60000,93,53703.263348157554,59911,299.55,29989,30011
80000,93,71570.55587251387,79909,399.54,40059,39941
100000,93,89578.8748113629,99907,499.53,49977,50023
2,94,1.524689626175431,1,0.01,2,0
3,94,2.1843315558973755,1,0.01,3,0
100,94,89.43090212696468,63,0.32,68,32
200,94,185.00791329493205,157,0.79,116,84
2000,94,1807.8458594695494,1939,9.7,1022,978
10000,94,8927.38337156751,9926,49.63,5098,4902
20000,94,17844.969488470466,19920,99.6,10058,9942
40000,94,35740.63504043731,39915,199.57,20031,19969
60000,94,53616.22572145755,59911,299.55,30170,29830
80000,94,71635.50869462441,79909,399.54,40176,39824
100000,94,89538.666066251,99907,499.53,50044,49956
2,95,1.6973918674594861,1,0.01,2,0
3,95,2.481573469862796,1,0.01,3,0
100,95,90.55761510616423,63,0.32,63,37
200,95,182.57280360957952,157,0.79,110,90
2000,95,1771.0608628591585,1939,9.7,1068,932
10000,95,8896.666767415181,9926,49.63,5132,4868
20000,95,17854.092114603518,19920,99.6,10122,9878
40000,95,35699.21350185571,39915,199.57,20082,19918
60000,95,53828.747461984,59911,299.55,29856,30144
80000,95,71672.98824809189,79909,399.54,40035,39965
100000,95,89549.16927113694,99907,499.53,49851,50149
2,96,1.2840301025403753,1,0.01,2,0
3,96,2.7887177309504327,1,0.01,2,1
100,96,89.48490021221957,63,0.32,66,34
200,96,179.94913925154705,157,0.79,122,78
2000,96,1780.6153298140316,1939,9.7,1038,962
10000,96,8949.07776961762,9926,49.63,5067,4933
20000,96,17814.613769912903,19920,99.6,10174,9826
40000,96,35898.22502022392,39915,199.57,19915,20085
60000,96,53579.77127271037,59911,299.55,30310,29690
80000,96,71626.19978728324,79909,399.54,39906,40094
100000,96,89378.95389415731,99907,499.53,50388,49612
2,97,2.045629503308208,1,0.01,1,1
3,97,2.9464439711993204,1,0.01,2,1
100,97,88.93891512855583,63,0.32,68,32
200,97,182.73906522005697,157,0.79,110,90
2000,97,1785.2762449651384,1939,9.7,1034,966
10000,97,8996.320503944586,9926,49.63,4933,5067
20000,97,17891.490764718495,19920,99.6,10023,9977
40000,97,35710.369444848955,39915,199.57,20184,19816
60000,97,53740.97459058093,59911,299.55,29862,30138
80000,97,71629.41767306627,79909,399.54,40000,40000
100000,97,89547.97824974735,99907,499.53,50028,49972
2,98,2.0851395219469397,1,0.01,1,1
3,98,2.2164179518975633,1,0.01,3,0
100,98,89.64801922843425,63,0.32,69,31
200,98,179.23106605468746,157,0.79,124,76
2000,98,1785.8444609000019,1939,9.7,1023,977
10000,98,8891.270190255509,9926,49.63,5109,4891
20000,98,17937.19609532004,19920,99.6,10013,9987
40000,98,35822.30927137811,39915,199.57,19988,20012
60000,98,53801.93193948591,59911,299.55,29845,30155
80000,98,71596.52329609415,79909,399.54,39929,40071
100000,98,89384.9628057944,99907,499.53,50210,49790
2,99,1.621351429055216,1,0.01,2,0
3,99,2.533081045095996,1,0.01,3,0
100,99,87.88306710867636,63,0.32,68,32
200,99,173.2301789752658,157,0.79,129,71
2000,99,1795.443040776703,1939,9.7,1007,993
10000,99,8930.596099741242,9926,49.63,5091,4909
20000,99,17904.25772964485,19920,99.6,9981,10019
40000,99,35728.114450974914,39915,199.57,20095,19905
60000,99,53727.119269881536,59911,299.55,29946,30054
80000,99,71730.20374846173,79909,399.54,39903,40097
100000,99,89508.22713831536,99907,499.53,50032,49968
2,100,2.287519548313564,1,0.01,1,1
3,100,2.59115524068748,1,0.01,3,0
100,100,89.14040976094502,63,0.32,70,30
200,100,187.61036518673717,157,0.79,113,87
2000,100,1794.185207474936,1939,9.7,1036,964
10000,100,8973.609349014834,9926,49.63,5015,4985
20000,100,17894.1835223495,19920,99.6,10007,9993
40000,100,35688.65420108185,39915,199.57,20218,19782
60000,100,53669.73793451355,59911,299.55,30213,29787
80000,100,71655.5868434337,79909,399.54,40034,39966
100000,100,89429.61065293525,99907,499.53,50265,49735
