Timestep,Iteration,Total Reward,Suboptimal Arms,Total Regret,Zeros Count,Ones Count
2,1,2.0,1,0.1,0,2
3,1,3.0,1,0.1,0,3
100,1,88.0,47,4.7,12,88
200,1,165.0,88,8.8,35,165
2000,1,1744.0,453,45.3,256,1744
10000,1,8944.0,611,61.1,1056,8944
20000,1,17973.0,690,69.0,2027,17973
40000,1,35991.0,798,79.8,4009,35991
60000,1,53995.0,841,84.1,6005,53995
80000,1,71976.0,868,86.8,8024,71976
100000,1,90007.0,911,91.1,9993,90007
2,2,2.0,1,0.1,0,2
3,2,3.0,1,0.1,0,3
100,2,86.0,51,5.1,14,86
200,2,175.0,93,9.3,25,175
2000,2,1742.0,449,44.9,258,1742
10000,2,8907.0,676,67.6,1093,8907
20000,2,17873.0,804,80.4,2127,17873
40000,2,35859.0,902,90.2,4141,35859
60000,2,53814.0,963,96.3,6186,53814
80000,2,71838.0,978,97.8,8162,71838
100000,2,89861.0,982,98.2,10139,89861
2,3,1.0,1,0.1,1,1
3,3,2.0,2,0.2,1,2
100,3,89.0,49,4.9,11,89
200,3,172.0,92,9.2,28,172
2000,3,1737.0,425,42.5,263,1737
10000,3,8919.0,726,72.6,1081,8919
20000,3,17921.0,836,83.6,2079,17921
40000,3,35912.0,933,93.3,4088,35912
60000,3,53880.0,1042,104.2,6120,53880
80000,3,71893.0,1073,107.3,8107,71893
100000,3,89920.0,1076,107.6,10080,89920
2,4,1.0,1,0.1,1,1
3,4,2.0,1,0.1,1,2
100,4,84.0,40,4.0,16,84
200,4,169.0,62,6.2,31,169
2000,4,1752.0,283,28.3,248,1752
10000,4,8897.0,397,39.7,1103,8897
20000,4,17861.0,437,43.7,2139,17861
40000,4,35859.0,495,49.5,4141,35859
60000,4,53926.0,518,51.8,6074,53926
80000,4,71914.0,535,53.5,8086,71914
100000,4,89862.0,540,54.0,10138,89862
2,5,2.0,1,0.1,0,2
3,5,3.0,1,0.1,0,3
100,5,90.0,46,4.6,10,90
200,5,174.0,86,8.6,26,174
2000,5,1773.0,319,31.9,227,1773
10000,5,8943.0,433,43.3,1057,8943
20000,5,17930.0,513,51.3,2070,17930
40000,5,35856.0,552,55.2,4144,35856
60000,5,53792.0,586,58.6,6208,53792
80000,5,71751.0,634,63.4,8249,71751
100000,5,89775.0,642,64.2,10225,89775
2,6,2.0,1,0.1,0,2
3,6,3.0,1,0.1,0,3
100,6,86.0,52,5.2,14,86
200,6,173.0,103,10.3,27,173
2000,6,1783.0,394,39.4,217,1783
10000,6,8980.0,740,74.0,1020,8980
20000,6,17941.0,828,82.8,2059,17941
40000,6,36001.0,868,86.8,3999,36001
60000,6,53989.0,933,93.3,6011,53989
80000,6,71962.0,948,94.8,8038,71962
100000,6,89930.0,1013,101.3,10070,89930
2,7,1.0,1,0.1,1,1
3,7,2.0,1,0.1,1,2
100,7,79.0,44,4.4,21,79
200,7,160.0,85,8.5,40,160
2000,7,1754.0,271,27.1,246,1754
10000,7,8943.0,360,36.0,1057,8943
20000,7,17967.0,395,39.5,2033,17967
40000,7,35961.0,433,43.3,4039,35961
60000,7,53975.0,500,50.0,6025,53975
80000,7,71950.0,508,50.8,8050,71950
100000,7,89968.0,522,52.2,10032,89968
2,8,2.0,1,0.1,0,2
3,8,3.0,1,0.1,0,3
100,8,88.0,47,4.7,12,88
200,8,176.0,91,9.1,24,176
2000,8,1749.0,464,46.4,251,1749
10000,8,8953.0,660,66.0,1047,8953
20000,8,17979.0,732,73.2,2021,17979
40000,8,36006.0,902,90.2,3994,36006
60000,8,53985.0,934,93.4,6015,53985
80000,8,72027.0,950,95.0,7973,72027
100000,8,90020.0,975,97.5,9980,90020
2,9,2.0,1,0.1,0,2
3,9,3.0,1,0.1,0,3
100,9,83.0,46,4.6,17,83
200,9,166.0,93,9.3,34,166
2000,9,1745.0,431,43.1,255,1745
10000,9,8930.0,840,84.0,1070,8930
20000,9,17922.0,902,90.2,2078,17922
40000,9,35914.0,965,96.5,4086,35914
60000,9,53930.0,1035,103.5,6070,53930
80000,9,71937.0,1052,105.2,8063,71937
100000,9,89934.0,1095,109.5,10066,89934
2,10,2.0,1,0.1,0,2
3,10,3.0,1,0.1,0,3
100,10,81.0,43,4.3,19,81
200,10,168.0,70,7.0,32,168
2000,10,1772.0,299,29.9,228,1772
10000,10,8952.0,473,47.3,1048,8952
20000,10,17927.0,512,51.2,2073,17927
40000,10,35855.0,562,56.2,4145,35855
60000,10,53869.0,594,59.4,6131,53869
80000,10,71901.0,599,59.9,8099,71901
100000,10,89890.0,667,66.7,10110,89890
2,11,2.0,1,0.1,0,2
3,11,3.0,1,0.1,0,3
100,11,85.0,47,4.7,15,85
200,11,167.0,93,9.3,33,167
2000,11,1720.0,343,34.3,280,1720
10000,11,8956.0,476,47.6,1044,8956
20000,11,17863.0,623,62.3,2137,17863
40000,11,35828.0,643,64.3,4172,35828
60000,11,53934.0,730,73.0,6066,53934
80000,11,71900.0,781,78.1,8100,71900
100000,11,89935.0,784,78.4,10065,89935
2,12,2.0,1,0.1,0,2
3,12,3.0,1,0.1,0,3
100,12,87.0,49,4.9,13,87
200,12,177.0,85,8.5,23,177
2000,12,1775.0,415,41.5,225,1775
10000,12,8959.0,764,76.4,1041,8959
20000,12,17976.0,878,87.8,2024,17976
40000,12,36060.0,941,94.1,3940,36060
60000,12,53999.0,992,99.2,6001,53999
80000,12,72049.0,1018,101.8,7951,72049
100000,12,90006.0,1031,103.1,9994,90006
2,13,2.0,1,0.1,0,2
3,13,3.0,1,0.1,0,3
100,13,88.0,48,4.8,12,88
200,13,174.0,90,9.0,26,174
2000,13,1779.0,395,39.5,221,1779
10000,13,8952.0,616,61.6,1048,8952
20000,13,17933.0,704,70.4,2067,17933
40000,13,35901.0,729,72.9,4099,35901
60000,13,53921.0,744,74.4,6079,53921
80000,13,71958.0,764,76.4,8042,71958
100000,13,89967.0,768,76.8,10033,89967
2,14,1.0,1,0.1,1,1
3,14,1.0,2,0.2,2,1
100,14,85.0,47,4.7,15,85
200,14,172.0,84,8.4,28,172
2000,14,1752.0,363,36.3,248,1752
10000,14,8914.0,563,56.3,1086,8914
20000,14,17886.0,652,65.2,2114,17886
40000,14,35836.0,683,68.3,4164,35836
60000,14,53930.0,687,68.7,6070,53930
80000,14,71917.0,708,70.8,8083,71917
100000,14,89932.0,762,76.2,10068,89932
2,15,2.0,1,0.1,0,2
3,15,3.0,1,0.1,0,3
100,15,85.0,42,4.2,15,85
200,15,176.0,78,7.8,24,176
2000,15,1767.0,356,35.6,233,1767
10000,15,8984.0,594,59.4,1016,8984
20000,15,17979.0,689,68.9,2021,17979
40000,15,35953.0,764,76.4,4047,35953
60000,15,53926.0,833,83.3,6074,53926
80000,15,71909.0,839,83.9,8091,71909
100000,15,89910.0,858,85.8,10090,89910
2,16,1.0,1,0.1,1,1
3,16,2.0,1,0.1,1,2
100,16,82.0,47,4.7,18,82
200,16,167.0,90,9.0,33,167
2000,16,1752.0,412,41.2,248,1752
10000,16,8904.0,688,68.8,1096,8904
20000,16,17908.0,741,74.1,2092,17908
40000,16,35889.0,851,85.1,4111,35889
60000,16,53984.0,892,89.2,6016,53984
80000,16,72006.0,916,91.6,7994,72006
100000,16,89887.0,932,93.2,10113,89887
2,17,1.0,1,0.1,1,1
3,17,2.0,1,0.1,1,2
100,17,83.0,41,4.1,17,83
200,17,172.0,79,7.9,28,172
2000,17,1768.0,436,43.6,232,1768
10000,17,8898.0,692,69.2,1102,8898
20000,17,17889.0,791,79.1,2111,17889
40000,17,35911.0,851,85.1,4089,35911
60000,17,53908.0,961,96.1,6092,53908
80000,17,71937.0,1008,100.8,8063,71937
100000,17,89986.0,1151,115.1,10014,89986
2,18,2.0,1,0.1,0,2
3,18,3.0,1,0.1,0,3
100,18,85.0,43,4.3,15,85
200,18,174.0,77,7.7,26,174
2000,18,1746.0,317,31.7,254,1746
10000,18,8933.0,502,50.2,1067,8933
20000,18,17947.0,605,60.5,2053,17947
40000,18,35991.0,687,68.7,4009,35991
60000,18,54043.0,804,80.4,5957,54043
80000,18,72045.0,918,91.8,7955,72045
100000,18,90030.0,939,93.9,9970,90030
2,19,1.0,1,0.1,1,1
3,19,2.0,1,0.1,1,2
100,19,87.0,45,4.5,13,87
200,19,171.0,78,7.8,29,171
2000,19,1763.0,329,32.9,237,1763
10000,19,8885.0,699,69.9,1115,8885
20000,19,17926.0,768,76.8,2074,17926
40000,19,35918.0,834,83.4,4082,35918
60000,19,53869.0,863,86.3,6131,53869
80000,19,71923.0,880,88.0,8077,71923
100000,19,89960.0,885,88.5,10040,89960
2,20,2.0,1,0.1,0,2
3,20,2.0,1,0.1,1,2
100,20,84.0,43,4.3,16,84
200,20,172.0,78,7.8,28,172
2000,20,1778.0,283,28.3,222,1778
10000,20,8953.0,613,61.3,1047,8953
20000,20,17902.0,760,76.0,2098,17902
40000,20,35877.0,812,81.2,4123,35877
60000,20,53921.0,883,88.3,6079,53921
80000,20,71916.0,894,89.4,8084,71916
100000,20,89879.0,909,90.9,10121,89879
2,21,2.0,1,0.1,0,2
3,21,2.0,1,0.1,1,2
100,21,82.0,46,4.6,18,82
200,21,171.0,77,7.7,29,171
2000,21,1756.0,337,33.7,244,1756
10000,21,8867.0,705,70.5,1133,8867
20000,21,17884.0,772,77.2,2116,17884
40000,21,35832.0,857,85.7,4168,35832
60000,21,53912.0,883,88.3,6088,53912
80000,21,71873.0,900,90.0,8127,71873
100000,21,89781.0,995,99.5,10219,89781
2,22,1.0,1,0.1,1,1
3,22,2.0,2,0.2,1,2
100,22,81.0,50,5.0,19,81
200,22,165.0,87,8.7,35,165
2000,22,1744.0,414,41.4,256,1744
10000,22,8911.0,558,55.8,1089,8911
20000,22,17914.0,619,61.9,2086,17914
40000,22,35851.0,726,72.6,4149,35851
60000,22,53874.0,745,74.5,6126,53874
80000,22,71837.0,761,76.1,8163,71837
100000,22,89835.0,772,77.2,10165,89835
2,23,1.0,1,0.1,1,1
3,23,2.0,2,0.2,1,2
100,23,86.0,46,4.6,14,86
200,23,175.0,82,8.2,25,175
2000,23,1790.0,330,33.0,210,1790
10000,23,8951.0,585,58.5,1049,8951
20000,23,17878.0,652,65.2,2122,17878
40000,23,35931.0,680,68.0,4069,35931
60000,23,53961.0,689,68.9,6039,53961
80000,23,71932.0,702,70.2,8068,71932
100000,23,89959.0,761,76.1,10041,89959
2,24,2.0,1,0.1,0,2
3,24,3.0,1,0.1,0,3
100,24,83.0,50,5.0,17,83
200,24,171.0,80,8.0,29,171
2000,24,1768.0,312,31.2,232,1768
10000,24,8962.0,685,68.5,1038,8962
20000,24,17990.0,743,74.3,2010,17990
40000,24,36025.0,849,84.9,3975,36025
60000,24,53963.0,905,90.5,6037,53963
80000,24,72018.0,940,94.0,7982,72018
100000,24,89942.0,1014,101.4,10058,89942
2,25,2.0,1,0.1,0,2
3,25,3.0,1,0.1,0,3
100,25,80.0,47,4.7,20,80
200,25,167.0,94,9.4,33,167
2000,25,1751.0,431,43.1,249,1751
10000,25,8946.0,688,68.8,1054,8946
20000,25,17939.0,761,76.1,2061,17939
40000,25,35909.0,895,89.5,4091,35909
60000,25,53896.0,951,95.1,6104,53896
80000,25,71881.0,992,99.2,8119,71881
100000,25,89832.0,1013,101.3,10168,89832
2,26,2.0,1,0.1,0,2
3,26,3.0,1,0.1,0,3
100,26,86.0,45,4.5,14,86
200,26,174.0,78,7.8,26,174
2000,26,1762.0,339,33.9,238,1762
10000,26,8917.0,626,62.6,1083,8917
20000,26,17980.0,713,71.3,2020,17980
40000,26,35998.0,748,74.8,4002,35998
60000,26,53980.0,805,80.5,6020,53980
80000,26,72032.0,820,82.0,7968,72032
100000,26,90067.0,830,83.0,9933,90067
2,27,2.0,1,0.1,0,2
3,27,3.0,1,0.1,0,3
100,27,79.0,45,4.5,21,79
200,27,170.0,94,9.4,30,170
2000,27,1755.0,495,49.5,245,1755
10000,27,8900.0,908,90.8,1100,8900
20000,27,17863.0,1006,100.6,2137,17863
40000,27,35845.0,1218,121.8,4155,35845
60000,27,53851.0,1267,126.7,6149,53851
80000,27,71783.0,1283,128.3,8217,71783
100000,27,89732.0,1394,139.4,10268,89732
2,28,2.0,1,0.1,0,2
3,28,3.0,1,0.1,0,3
100,28,87.0,43,4.3,13,87
200,28,179.0,81,8.1,21,179
2000,28,1749.0,447,44.7,251,1749
10000,28,8937.0,654,65.4,1063,8937
20000,28,17914.0,752,75.2,2086,17914
40000,28,35865.0,800,80.0,4135,35865
60000,28,53858.0,854,85.4,6142,53858
80000,28,71893.0,872,87.2,8107,71893
100000,28,89976.0,874,87.4,10024,89976
2,29,2.0,1,0.1,0,2
3,29,2.0,1,0.1,1,2
100,29,83.0,47,4.7,17,83
200,29,173.0,85,8.5,27,173
2000,29,1751.0,361,36.1,249,1751
10000,29,8911.0,606,60.6,1089,8911
20000,29,17930.0,679,67.9,2070,17930
40000,29,35917.0,759,75.9,4083,35917
60000,29,53955.0,815,81.5,6045,53955
80000,29,72027.0,850,85.0,7973,72027
100000,29,90080.0,864,86.4,9920,90080
2,30,1.0,1,0.1,1,1
3,30,2.0,1,0.1,1,2
100,30,90.0,48,4.8,10,90
200,30,173.0,84,8.4,27,173
2000,30,1766.0,402,40.2,234,1766
10000,30,8909.0,741,74.1,1091,8909
20000,30,17902.0,836,83.6,2098,17902
40000,30,35887.0,892,89.2,4113,35887
60000,30,53887.0,935,93.5,6113,53887
80000,30,71922.0,939,93.9,8078,71922
100000,30,89949.0,948,94.8,10051,89949
2,31,2.0,1,0.1,0,2
3,31,3.0,1,0.1,0,3
100,31,83.0,46,4.6,17,83
200,31,165.0,83,8.3,35,165
2000,31,1784.0,307,30.7,216,1784
10000,31,8959.0,589,58.9,1041,8959
20000,31,17979.0,698,69.8,2021,17979
40000,31,35940.0,798,79.8,4060,35940
60000,31,53972.0,891,89.1,6028,53972
80000,31,71961.0,948,94.8,8039,71961
100000,31,89966.0,951,95.1,10034,89966
2,32,2.0,1,0.1,0,2
3,32,3.0,1,0.1,0,3
100,32,90.0,49,4.9,10,90
200,32,176.0,96,9.6,24,176
2000,32,1764.0,412,41.2,236,1764
10000,32,8940.0,597,59.7,1060,8940
20000,32,17906.0,692,69.2,2094,17906
40000,32,35820.0,954,95.4,4180,35820
60000,32,53840.0,1018,101.8,6160,53840
80000,32,71834.0,1038,103.8,8166,71834
100000,32,89865.0,1053,105.3,10135,89865
2,33,2.0,1,0.1,0,2
3,33,3.0,1,0.1,0,3
100,33,90.0,46,4.6,10,90
200,33,175.0,91,9.1,25,175
2000,33,1748.0,381,38.1,252,1748
10000,33,8977.0,607,60.7,1023,8977
20000,33,17968.0,766,76.6,2032,17968
40000,33,36003.0,856,85.6,3997,36003
60000,33,54135.0,880,88.0,5865,54135
80000,33,72136.0,919,91.9,7864,72136
100000,33,90086.0,1011,101.1,9914,90086
2,34,2.0,1,0.1,0,2
3,34,3.0,1,0.1,0,3
100,34,87.0,48,4.8,13,87
200,34,170.0,89,8.9,30,170
2000,34,1762.0,267,26.7,238,1762
10000,34,8936.0,604,60.4,1064,8936
20000,34,17899.0,713,71.3,2101,17899
40000,34,35931.0,807,80.7,4069,35931
60000,34,53899.0,829,82.9,6101,53899
80000,34,71871.0,854,85.4,8129,71871
100000,34,89911.0,870,87.0,10089,89911
2,35,1.0,1,0.1,1,1
3,35,2.0,1,0.1,1,2
100,35,82.0,45,4.5,18,82
200,35,165.0,82,8.2,35,165
2000,35,1766.0,284,28.4,234,1766
10000,35,8980.0,410,41.0,1020,8980
20000,35,17969.0,466,46.6,2031,17969
40000,35,35947.0,516,51.6,4053,35947
60000,35,53947.0,546,54.6,6053,53947
80000,35,71957.0,559,55.9,8043,71957
100000,35,89946.0,562,56.2,10054,89946
2,36,1.0,1,0.1,1,1
3,36,2.0,2,0.2,1,2
100,36,87.0,49,4.9,13,87
200,36,173.0,93,9.3,27,173
2000,36,1750.0,464,46.4,250,1750
10000,36,8916.0,674,67.4,1084,8916
20000,36,17890.0,807,80.7,2110,17890
40000,36,35870.0,880,88.0,4130,35870
60000,36,53849.0,896,89.6,6151,53849
80000,36,71848.0,938,93.8,8152,71848
100000,36,89722.0,962,96.2,10278,89722
2,37,2.0,1,0.1,0,2
3,37,3.0,1,0.1,0,3
100,37,87.0,43,4.3,13,87
200,37,174.0,78,7.8,26,174
2000,37,1757.0,362,36.2,243,1757
10000,37,8905.0,591,59.1,1095,8905
20000,37,17917.0,638,63.8,2083,17917
40000,37,35859.0,698,69.8,4141,35859
60000,37,53807.0,781,78.1,6193,53807
80000,37,71758.0,786,78.6,8242,71758
100000,37,89733.0,828,82.8,10267,89733
2,38,2.0,1,0.1,0,2
3,38,3.0,1,0.1,0,3
100,38,81.0,45,4.5,19,81
200,38,166.0,73,7.3,34,166
2000,38,1767.0,428,42.8,233,1767
10000,38,8949.0,647,64.7,1051,8949
20000,38,17962.0,689,68.9,2038,17962
40000,38,35866.0,732,73.2,4134,35866
60000,38,53900.0,793,79.3,6100,53900
80000,38,71877.0,814,81.4,8123,71877
100000,38,89866.0,820,82.0,10134,89866
2,39,1.0,1,0.1,1,1
3,39,1.0,2,0.2,2,1
100,39,86.0,42,4.2,14,86
200,39,175.0,72,7.2,25,175
2000,39,1761.0,286,28.6,239,1761
10000,39,8945.0,470,47.0,1055,8945
20000,39,17914.0,595,59.5,2086,17914
40000,39,35927.0,636,63.6,4073,35927
60000,39,53910.0,676,67.6,6090,53910
80000,39,71933.0,689,68.9,8067,71933
100000,39,89950.0,695,69.5,10050,89950
2,40,1.0,1,0.1,1,1
3,40,2.0,2,0.2,1,2
100,40,83.0,49,4.9,17,83
200,40,171.0,91,9.1,29,171
2000,40,1751.0,449,44.9,249,1751
10000,40,8956.0,744,74.4,1044,8956
20000,40,17955.0,978,97.8,2045,17955
40000,40,35867.0,1099,109.9,4133,35867
60000,40,53799.0,1125,112.5,6201,53799
80000,40,71805.0,1161,116.1,8195,71805
100000,40,89834.0,1170,117.0,10166,89834
2,41,1.0,1,0.1,1,1
3,41,2.0,1,0.1,1,2
100,41,85.0,49,4.9,15,85
200,41,175.0,93,9.3,25,175
2000,41,1767.0,376,37.6,233,1767
10000,41,8942.0,733,73.3,1058,8942
20000,41,17877.0,879,87.9,2123,17877
40000,41,35870.0,944,94.4,4130,35870
60000,41,53910.0,970,97.0,6090,53910
80000,41,71958.0,984,98.4,8042,71958
100000,41,89897.0,1020,102.0,10103,89897
2,42,0.0,1,0.1,2,0
3,42,1.0,1,0.1,2,1
100,42,81.0,50,5.0,19,81
200,42,168.0,93,9.3,32,168
2000,42,1784.0,381,38.1,216,1784
10000,42,8972.0,657,65.7,1028,8972
20000,42,17954.0,819,81.9,2046,17954
40000,42,35952.0,942,94.2,4048,35952
60000,42,53936.0,956,95.6,6064,53936
80000,42,71965.0,1067,106.7,8035,71965
100000,42,89859.0,1113,111.3,10141,89859
2,43,2.0,1,0.1,0,2
3,43,3.0,1,0.1,0,3
100,43,83.0,44,4.4,17,83
200,43,168.0,74,7.4,32,168
2000,43,1749.0,347,34.7,251,1749
10000,43,8928.0,517,51.7,1072,8928
20000,43,17872.0,618,61.8,2128,17872
40000,43,35905.0,642,64.2,4095,35905
60000,43,53919.0,661,66.1,6081,53919
80000,43,71918.0,675,67.5,8082,71918
100000,43,89958.0,682,68.2,10042,89958
2,44,2.0,1,0.1,0,2
3,44,3.0,1,0.1,0,3
100,44,90.0,49,4.9,10,90
200,44,174.0,87,8.7,26,174
2000,44,1781.0,326,32.6,219,1781
10000,44,8954.0,683,68.3,1046,8954
20000,44,17988.0,873,87.3,2012,17988
40000,44,36006.0,930,93.0,3994,36006
60000,44,54019.0,1032,103.2,5981,54019
80000,44,72041.0,1050,105.0,7959,72041
100000,44,90022.0,1076,107.6,9978,90022
2,45,2.0,1,0.1,0,2
3,45,3.0,1,0.1,0,3
100,45,87.0,53,5.3,13,87
200,45,172.0,102,10.2,28,172
2000,45,1758.0,405,40.5,242,1758
10000,45,8944.0,645,64.5,1056,8944
20000,45,17918.0,799,79.9,2082,17918
40000,45,35855.0,935,93.5,4145,35855
60000,45,53839.0,1003,100.3,6161,53839
80000,45,71835.0,1063,106.3,8165,71835
100000,45,89884.0,1081,108.1,10116,89884
2,46,1.0,1,0.1,1,1
3,46,2.0,1,0.1,1,2
100,46,84.0,50,5.0,16,84
200,46,173.0,97,9.7,27,173
2000,46,1760.0,422,42.2,240,1760
10000,46,8937.0,652,65.2,1063,8937
20000,46,17886.0,760,76.0,2114,17886
40000,46,35887.0,846,84.6,4113,35887
60000,46,53906.0,891,89.1,6094,53906
80000,46,71988.0,937,93.7,8012,71988
100000,46,89965.0,975,97.5,10035,89965
2,47,2.0,1,0.1,0,2
3,47,3.0,1,0.1,0,3
100,47,82.0,45,4.5,18,82
200,47,172.0,89,8.9,28,172
2000,47,1734.0,372,37.2,266,1734
10000,47,8893.0,514,51.4,1107,8893
20000,47,17870.0,539,53.9,2130,17870
40000,47,35857.0,578,57.8,4143,35857
60000,47,53838.0,726,72.6,6162,53838
80000,47,71861.0,749,74.9,8139,71861
100000,47,89917.0,750,75.0,10083,89917
2,48,1.0,1,0.1,1,1
3,48,2.0,1,0.1,1,2
100,48,88.0,47,4.7,12,88
200,48,174.0,91,9.1,26,174
2000,48,1782.0,355,35.5,218,1782
10000,48,8995.0,504,50.4,1005,8995
20000,48,17983.0,568,56.8,2017,17983
40000,48,35939.0,665,66.5,4061,35939
60000,48,53887.0,683,68.3,6113,53887
80000,48,71883.0,704,70.4,8117,71883
100000,48,89850.0,710,71.0,10150,89850
2,49,2.0,1,0.1,0,2
3,49,3.0,1,0.1,0,3
100,49,85.0,45,4.5,15,85
200,49,170.0,80,8.0,30,170
2000,49,1777.0,341,34.1,223,1777
10000,49,8991.0,471,47.1,1009,8991
20000,49,17997.0,625,62.5,2003,17997
40000,49,36017.0,690,69.0,3983,36017
60000,49,53981.0,750,75.0,6019,53981
80000,49,71971.0,772,77.2,8029,71971
100000,49,89978.0,813,81.3,10022,89978
2,50,2.0,1,0.1,0,2
3,50,3.0,1,0.1,0,3
100,50,85.0,47,4.7,15,85
200,50,167.0,93,9.3,33,167
2000,50,1734.0,368,36.8,266,1734
10000,50,8900.0,529,52.9,1100,8900
20000,50,17921.0,584,58.4,2079,17921
40000,50,35904.0,637,63.7,4096,35904
60000,50,53872.0,698,69.8,6128,53872
80000,50,71822.0,730,73.0,8178,71822
100000,50,89773.0,757,75.7,10227,89773
2,51,2.0,1,0.1,0,2
3,51,3.0,1,0.1,0,3
100,51,88.0,47,4.7,12,88
200,51,171.0,84,8.4,29,171
2000,51,1743.0,299,29.9,257,1743
10000,51,8965.0,416,41.6,1035,8965
20000,51,17988.0,536,53.6,2012,17988
40000,51,36049.0,615,61.5,3951,36049
60000,51,54053.0,648,64.8,5947,54053
80000,51,72069.0,695,69.5,7931,72069
100000,51,90072.0,728,72.8,9928,90072
2,52,2.0,1,0.1,0,2
3,52,3.0,1,0.1,0,3
100,52,86.0,46,4.6,14,86
200,52,169.0,80,8.0,31,169
2000,52,1782.0,263,26.3,218,1782
10000,52,8977.0,453,45.3,1023,8977
20000,52,17987.0,518,51.8,2013,17987
40000,52,36008.0,614,61.4,3992,36008
60000,52,54054.0,652,65.2,5946,54054
80000,52,72032.0,765,76.5,7968,72032
100000,52,90045.0,773,77.3,9955,90045
2,53,2.0,1,0.1,0,2
3,53,3.0,1,0.1,0,3
100,53,85.0,51,5.1,15,85
200,53,167.0,90,9.0,33,167
2000,53,1727.0,427,42.7,273,1727
10000,53,8874.0,741,74.1,1126,8874
20000,53,17864.0,830,83.0,2136,17864
40000,53,35865.0,859,85.9,4135,35865
60000,53,53894.0,880,88.0,6106,53894
80000,53,71854.0,907,90.7,8146,71854
100000,53,89867.0,924,92.4,10133,89867
2,54,2.0,1,0.1,0,2
3,54,3.0,1,0.1,0,3
100,54,83.0,46,4.6,17,83
200,54,165.0,83,8.3,35,165
2000,54,1764.0,317,31.7,236,1764
10000,54,8900.0,513,51.3,1100,8900
20000,54,17838.0,617,61.7,2162,17838
40000,54,35844.0,626,62.6,4156,35844
60000,54,53887.0,631,63.1,6113,53887
80000,54,71883.0,646,64.6,8117,71883
100000,54,89992.0,656,65.6,10008,89992
2,55,2.0,1,0.1,0,2
3,55,3.0,1,0.1,0,3
100,55,86.0,50,5.0,14,86
200,55,177.0,85,8.5,23,177
2000,55,1779.0,295,29.5,221,1779
10000,55,8941.0,599,59.9,1059,8941
20000,55,17905.0,687,68.7,2095,17905
40000,55,35915.0,730,73.0,4085,35915
60000,55,53899.0,777,77.7,6101,53899
80000,55,71949.0,830,83.0,8051,71949
100000,55,89926.0,837,83.7,10074,89926
2,56,2.0,1,0.1,0,2
3,56,3.0,1,0.1,0,3
100,56,83.0,45,4.5,17,83
200,56,176.0,82,8.2,24,176
2000,56,1791.0,423,42.3,209,1791
10000,56,8956.0,781,78.1,1044,8956
20000,56,17974.0,904,90.4,2026,17974
40000,56,35975.0,1067,106.7,4025,35975
60000,56,54048.0,1097,109.7,5952,54048
80000,56,72015.0,1116,111.6,7985,72015
100000,56,90084.0,1151,115.1,9916,90084
2,57,1.0,1,0.1,1,1
3,57,2.0,1,0.1,1,2
100,57,85.0,46,4.6,15,85
200,57,173.0,82,8.2,27,173
2000,57,1775.0,383,38.3,225,1775
10000,57,8997.0,656,65.6,1003,8997
20000,57,18026.0,741,74.1,1974,18026
40000,57,36043.0,774,77.4,3957,36043
60000,57,54031.0,811,81.1,5969,54031
80000,57,72003.0,834,83.4,7997,72003
100000,57,89993.0,846,84.6,10007,89993
2,58,2.0,1,0.1,0,2
3,58,3.0,1,0.1,0,3
100,58,89.0,54,5.4,11,89
200,58,172.0,102,10.2,28,172
2000,58,1764.0,403,40.3,236,1764
10000,58,8908.0,696,69.6,1092,8908
20000,58,17936.0,765,76.5,2064,17936
40000,58,35999.0,864,86.4,4001,35999
60000,58,53980.0,888,88.8,6020,53980
80000,58,71955.0,931,93.1,8045,71955
100000,58,89893.0,996,99.6,10107,89893
2,59,2.0,1,0.1,0,2
3,59,3.0,1,0.1,0,3
100,59,82.0,45,4.5,18,82
200,59,168.0,87,8.7,32,168
2000,59,1742.0,452,45.2,258,1742
10000,59,8969.0,665,66.5,1031,8969
20000,59,17942.0,735,73.5,2058,17942
40000,59,35814.0,962,96.2,4186,35814
60000,59,53885.0,970,97.0,6115,53885
80000,59,71839.0,999,99.9,8161,71839
100000,59,89853.0,1006,100.6,10147,89853
2,60,1.0,1,0.1,1,1
3,60,1.0,1,0.1,2,1
100,60,85.0,42,4.2,15,85
200,60,175.0,87,8.7,25,175
2000,60,1760.0,430,43.0,240,1760
10000,60,8907.0,641,64.1,1093,8907
20000,60,17922.0,683,68.3,2078,17922
40000,60,35965.0,732,73.2,4035,35965
60000,60,53929.0,797,79.7,6071,53929
80000,60,71937.0,811,81.1,8063,71937
100000,60,89922.0,851,85.1,10078,89922
2,61,1.0,1,0.1,1,1
3,61,2.0,1,0.1,1,2
100,61,88.0,47,4.7,12,88
200,61,174.0,85,8.5,26,174
2000,61,1770.0,358,35.8,230,1770
10000,61,8983.0,647,64.7,1017,8983
20000,61,17975.0,752,75.2,2025,17975
40000,61,35909.0,855,85.5,4091,35909
60000,61,53845.0,943,94.3,6155,53845
80000,61,71906.0,955,95.5,8094,71906
100000,61,89997.0,1014,101.4,10003,89997
2,62,2.0,1,0.1,0,2
3,62,3.0,1,0.1,0,3
100,62,90.0,46,4.6,10,90
200,62,174.0,85,8.5,26,174
2000,62,1759.0,368,36.8,241,1759
10000,62,8947.0,545,54.5,1053,8947
20000,62,17935.0,610,61.0,2065,17935
40000,62,35940.0,656,65.6,4060,35940
60000,62,53914.0,742,74.2,6086,53914
80000,62,71890.0,755,75.5,8110,71890
100000,62,89898.0,809,80.9,10102,89898
2,63,2.0,1,0.1,0,2
3,63,2.0,1,0.1,1,2
100,63,88.0,46,4.6,12,88
200,63,174.0,92,9.2,26,174
2000,63,1768.0,409,40.9,232,1768
10000,63,8957.0,658,65.8,1043,8957
20000,63,17903.0,782,78.2,2097,17903
40000,63,35894.0,876,87.6,4106,35894
60000,63,53964.0,924,92.4,6036,53964
80000,63,71895.0,945,94.5,8105,71895
100000,63,89885.0,952,95.2,10115,89885
2,64,2.0,1,0.1,0,2
3,64,3.0,1,0.1,0,3
100,64,87.0,47,4.7,13,87
200,64,168.0,87,8.7,32,168
2000,64,1773.0,333,33.3,227,1773
10000,64,8938.0,647,64.7,1062,8938
20000,64,17986.0,744,74.4,2014,17986
40000,64,35881.0,845,84.5,4119,35881
60000,64,53918.0,889,88.9,6082,53918
80000,64,71940.0,895,89.5,8060,71940
100000,64,89885.0,923,92.3,10115,89885
2,65,1.0,1,0.1,1,1
3,65,2.0,1,0.1,1,2
100,65,80.0,47,4.7,20,80
200,65,168.0,80,8.0,32,168
2000,65,1773.0,298,29.8,227,1773
10000,65,8998.0,491,49.1,1002,8998
20000,65,17971.0,671,67.1,2029,17971
40000,65,35905.0,724,72.4,4095,35905
60000,65,53864.0,783,78.3,6136,53864
80000,65,71821.0,813,81.3,8179,71821
100000,65,89823.0,861,86.1,10177,89823
2,66,2.0,1,0.1,0,2
3,66,3.0,1,0.1,0,3
100,66,84.0,43,4.3,16,84
200,66,167.0,71,7.1,33,167
2000,66,1764.0,279,27.9,236,1764
10000,66,8982.0,518,51.8,1018,8982
20000,66,18000.0,611,61.1,2000,18000
40000,66,35923.0,670,67.0,4077,35923
60000,66,53917.0,683,68.3,6083,53917
80000,66,72027.0,708,70.8,7973,72027
100000,66,89968.0,753,75.3,10032,89968
2,67,2.0,1,0.1,0,2
3,67,3.0,1,0.1,0,3
100,67,85.0,48,4.8,15,85
200,67,167.0,89,8.9,33,167
2000,67,1772.0,309,30.9,228,1772
10000,67,8936.0,454,45.4,1064,8936
20000,67,17941.0,494,49.4,2059,17941
40000,67,35940.0,529,52.9,4060,35940
60000,67,53953.0,556,55.6,6047,53953
80000,67,71930.0,585,58.5,8070,71930
100000,67,89934.0,618,61.8,10066,89934
2,68,2.0,1,0.1,0,2
3,68,3.0,1,0.1,0,3
100,68,83.0,49,4.9,17,83
200,68,169.0,84,8.4,31,169
2000,68,1768.0,358,35.8,232,1768
10000,68,8959.0,562,56.2,1041,8959
20000,68,17950.0,641,64.1,2050,17950
40000,68,35922.0,697,69.7,4078,35922
60000,68,54007.0,703,70.3,5993,54007
80000,68,72013.0,715,71.5,7987,72013
100000,68,89980.0,747,74.7,10020,89980
2,69,2.0,1,0.1,0,2
3,69,3.0,1,0.1,0,3
100,69,86.0,48,4.8,14,86
200,69,174.0,93,9.3,26,174
2000,69,1749.0,385,38.5,251,1749
10000,69,8928.0,643,64.3,1072,8928
20000,69,17964.0,681,68.1,2036,17964
40000,69,35800.0,898,89.8,4200,35800
60000,69,53840.0,905,90.5,6160,53840
80000,69,71878.0,966,96.6,8122,71878
100000,69,89903.0,970,97.0,10097,89903
2,70,1.0,1,0.1,1,1
3,70,2.0,1,0.1,1,2
100,70,87.0,45,4.5,13,87
200,70,177.0,85,8.5,23,177
2000,70,1783.0,409,40.9,217,1783
10000,70,8911.0,711,71.1,1089,8911
20000,70,17925.0,747,74.7,2075,17925
40000,70,35870.0,794,79.4,4130,35870
60000,70,53811.0,814,81.4,6189,53811
80000,70,71851.0,840,84.0,8149,71851
100000,70,89883.0,880,88.0,10117,89883
2,71,2.0,1,0.1,0,2
3,71,3.0,1,0.1,0,3
100,71,86.0,46,4.6,14,86
200,71,169.0,77,7.7,31,169
2000,71,1745.0,418,41.8,255,1745
10000,71,8901.0,707,70.7,1099,8901
20000,71,17879.0,760,76.0,2121,17879
40000,71,35820.0,845,84.5,4180,35820
60000,71,53832.0,869,86.9,6168,53832
80000,71,71852.0,932,93.2,8148,71852
100000,71,89796.0,953,95.3,10204,89796
2,72,1.0,1,0.1,1,1
3,72,2.0,2,0.2,1,2
100,72,82.0,46,4.6,18,82
200,72,172.0,89,8.9,28,172
2000,72,1771.0,419,41.9,229,1771
10000,72,8963.0,741,74.1,1037,8963
20000,72,17989.0,775,77.5,2011,17989
40000,72,35992.0,881,88.1,4008,35992
60000,72,53909.0,951,95.1,6091,53909
80000,72,71952.0,994,99.4,8048,71952
100000,72,89938.0,1027,102.7,10062,89938
2,73,2.0,1,0.1,0,2
3,73,2.0,1,0.1,1,2
100,73,86.0,42,4.2,14,86
200,73,172.0,71,7.1,28,172
2000,73,1782.0,349,34.9,218,1782
10000,73,8961.0,647,64.7,1039,8961
20000,73,17950.0,744,74.4,2050,17950
40000,73,35969.0,796,79.6,4031,35969
60000,73,53990.0,814,81.4,6010,53990
80000,73,72019.0,838,83.8,7981,72019
100000,73,89956.0,873,87.3,10044,89956
2,74,1.0,1,0.1,1,1
3,74,2.0,1,0.1,1,2
100,74,87.0,43,4.3,13,87
200,74,167.0,76,7.6,33,167
2000,74,1763.0,297,29.7,237,1763
10000,74,8937.0,508,50.8,1063,8937
20000,74,17949.0,577,57.7,2051,17949
40000,74,35855.0,731,73.1,4145,35855
60000,74,53925.0,755,75.5,6075,53925
80000,74,71934.0,763,76.3,8066,71934
100000,74,89913.0,774,77.4,10087,89913
2,75,2.0,1,0.1,0,2
3,75,3.0,1,0.1,0,3
100,75,85.0,43,4.3,15,85
200,75,167.0,72,7.2,33,167
2000,75,1790.0,290,29.0,210,1790
10000,75,8956.0,599,59.9,1044,8956
20000,75,17953.0,671,67.1,2047,17953
40000,75,35945.0,823,82.3,4055,35945
60000,75,53969.0,845,84.5,6031,53969
80000,75,71948.0,882,88.2,8052,71948
100000,75,89900.0,918,91.8,10100,89900
2,76,2.0,1,0.1,0,2
3,76,3.0,1,0.1,0,3
100,76,81.0,32,3.2,19,81
200,76,172.0,64,6.4,28,172
2000,76,1782.0,313,31.3,218,1782
10000,76,8998.0,486,48.6,1002,8998
20000,76,18041.0,533,53.3,1959,18041
40000,76,35966.0,627,62.7,4034,35966
60000,76,53982.0,719,71.9,6018,53982
80000,76,72059.0,881,88.1,7941,72059
100000,76,90060.0,908,90.8,9940,90060
2,77,1.0,1,0.1,1,1
3,77,2.0,2,0.2,1,2
100,77,88.0,45,4.5,12,88
200,77,173.0,82,8.2,27,173
2000,77,1754.0,460,46.0,246,1754
10000,77,8948.0,659,65.9,1052,8948
20000,77,17945.0,744,74.4,2055,17945
40000,77,35954.0,799,79.9,4046,35954
60000,77,53910.0,821,82.1,6090,53910
80000,77,71910.0,837,83.7,8090,71910
100000,77,89873.0,875,87.5,10127,89873
2,78,1.0,1,0.1,1,1
3,78,2.0,1,0.1,1,2
100,78,85.0,49,4.9,15,85
200,78,171.0,86,8.6,29,171
2000,78,1778.0,351,35.1,222,1778
10000,78,8948.0,571,57.1,1052,8948
20000,78,17910.0,663,66.3,2090,17910
40000,78,35800.0,713,71.3,4200,35800
60000,78,53840.0,720,72.0,6160,53840
80000,78,71824.0,757,75.7,8176,71824
100000,78,89820.0,797,79.7,10180,89820
2,79,1.0,1,0.1,1,1
3,79,2.0,1,0.1,1,2
100,79,85.0,45,4.5,15,85
200,79,175.0,83,8.3,25,175
2000,79,1763.0,394,39.4,237,1763
10000,79,8956.0,589,58.9,1044,8956
20000,79,17931.0,626,62.6,2069,17931
40000,79,35976.0,661,66.1,4024,35976
60000,79,53941.0,688,68.8,6059,53941
80000,79,71977.0,738,73.8,8023,71977
100000,79,90069.0,763,76.3,9931,90069
2,80,2.0,1,0.1,0,2
3,80,3.0,1,0.1,0,3
100,80,89.0,46,4.6,11,89
200,80,174.0,85,8.5,26,174
2000,80,1777.0,341,34.1,223,1777
10000,80,8909.0,516,51.6,1091,8909
20000,80,17890.0,583,58.3,2110,17890
40000,80,35900.0,667,66.7,4100,35900
60000,80,53892.0,692,69.2,6108,53892
80000,80,71888.0,706,70.6,8112,71888
100000,80,89907.0,710,71.0,10093,89907
2,81,1.0,1,0.1,1,1
3,81,2.0,1,0.1,1,2
100,81,87.0,50,5.0,13,87
200,81,170.0,92,9.2,30,170
2000,81,1766.0,306,30.6,234,1766
10000,81,8960.0,572,57.2,1040,8960
20000,81,17946.0,657,65.7,2054,17946
40000,81,35980.0,788,78.8,4020,35980
60000,81,53971.0,997,99.7,6029,53971
80000,81,72035.0,1006,100.6,7965,72035
100000,81,89989.0,1100,110.0,10011,89989
2,82,1.0,1,0.1,1,1
3,82,2.0,1,0.1,1,2
100,82,87.0,47,4.7,13,87
200,82,169.0,91,9.1,31,169
2000,82,1772.0,307,30.7,228,1772
10000,82,9001.0,567,56.7,999,9001
20000,82,18012.0,644,64.4,1988,18012
40000,82,35989.0,836,83.6,4011,35989
60000,82,53970.0,881,88.1,6030,53970
80000,82,71958.0,916,91.6,8042,71958
100000,82,90031.0,927,92.7,9969,90031
2,83,2.0,1,0.1,0,2
3,83,3.0,1,0.1,0,3
100,83,80.0,49,4.9,20,80
200,83,171.0,96,9.6,29,171
2000,83,1768.0,362,36.2,232,1768
10000,83,8933.0,592,59.2,1067,8933
20000,83,17898.0,850,85.0,2102,17898
40000,83,35878.0,922,92.2,4122,35878
60000,83,53888.0,948,94.8,6112,53888
80000,83,71902.0,968,96.8,8098,71902
100000,83,89976.0,975,97.5,10024,89976
2,84,1.0,1,0.1,1,1
3,84,2.0,1,0.1,1,2
100,84,82.0,46,4.6,18,82
200,84,168.0,84,8.4,32,168
2000,84,1755.0,326,32.6,245,1755
10000,84,8945.0,577,57.7,1055,8945
20000,84,17956.0,626,62.6,2044,17956
40000,84,35900.0,734,73.4,4100,35900
60000,84,53871.0,780,78.0,6129,53871
80000,84,71800.0,790,79.0,8200,71800
100000,84,89883.0,840,84.0,10117,89883
2,85,2.0,1,0.1,0,2
3,85,3.0,1,0.1,0,3
100,85,86.0,42,4.2,14,86
200,85,169.0,74,7.4,31,169
2000,85,1754.0,361,36.1,246,1754
10000,85,8953.0,583,58.3,1047,8953
20000,85,17944.0,829,82.9,2056,17944
40000,85,35924.0,926,92.6,4076,35924
60000,85,53898.0,958,95.8,6102,53898
80000,85,71926.0,1018,101.8,8074,71926
100000,85,89894.0,1027,102.7,10106,89894
2,86,2.0,1,0.1,0,2
3,86,2.0,1,0.1,1,2
100,86,87.0,45,4.5,13,87
200,86,176.0,86,8.6,24,176
2000,86,1781.0,414,41.4,219,1781
10000,86,8895.0,576,57.6,1105,8895
20000,86,17908.0,599,59.9,2092,17908
40000,86,35878.0,802,80.2,4122,35878
60000,86,53807.0,832,83.2,6193,53807
80000,86,71741.0,885,88.5,8259,71741
100000,86,89709.0,915,91.5,10291,89709
2,87,1.0,1,0.1,1,1
3,87,1.0,2,0.2,2,1
100,87,81.0,39,3.9,19,81
200,87,171.0,67,6.7,29,171
2000,87,1766.0,388,38.8,234,1766
10000,87,8941.0,627,62.7,1059,8941
20000,87,17911.0,791,79.1,2089,17911
40000,87,35847.0,885,88.5,4153,35847
60000,87,53844.0,923,92.3,6156,53844
80000,87,71883.0,974,97.4,8117,71883
100000,87,89916.0,985,98.5,10084,89916
2,88,2.0,1,0.1,0,2
3,88,3.0,1,0.1,0,3
100,88,90.0,47,4.7,10,90
200,88,177.0,86,8.6,23,177
2000,88,1786.0,334,33.4,214,1786
10000,88,8950.0,554,55.4,1050,8950
20000,88,17908.0,638,63.8,2092,17908
40000,88,35920.0,697,69.7,4080,35920
60000,88,53915.0,740,74.0,6085,53915
80000,88,71945.0,745,74.5,8055,71945
100000,88,89936.0,749,74.9,10064,89936
2,89,1.0,1,0.1,1,1
3,89,2.0,1,0.1,1,2
100,89,82.0,47,4.7,18,82
200,89,169.0,84,8.4,31,169
2000,89,1753.0,419,41.9,247,1753
10000,89,8877.0,774,77.4,1123,8877
20000,89,17844.0,831,83.1,2156,17844
40000,89,35828.0,851,85.1,4172,35828
60000,89,53754.0,874,87.4,6246,53754
80000,89,71721.0,892,89.2,8279,71721
100000,89,89746.0,905,90.5,10254,89746
2,90,2.0,1,0.1,0,2
3,90,3.0,1,0.1,0,3
100,90,84.0,42,4.2,16,84
200,90,176.0,77,7.7,24,176
2000,90,1770.0,471,47.1,230,1770
10000,90,8913.0,732,73.2,1087,8913
20000,90,17878.0,833,83.3,2122,17878
40000,90,35929.0,912,91.2,4071,35929
60000,90,53914.0,950,95.0,6086,53914
80000,90,71872.0,1010,101.0,8128,71872
100000,90,89920.0,1083,108.3,10080,89920
2,91,2.0,1,0.1,0,2
3,91,3.0,1,0.1,0,3
100,91,85.0,44,4.4,15,85
200,91,171.0,76,7.6,29,171
2000,91,1759.0,270,27.0,241,1759
10000,91,8929.0,494,49.4,1071,8929
20000,91,17909.0,520,52.0,2091,17909
40000,91,35967.0,600,60.0,4033,35967
60000,91,53958.0,648,64.8,6042,53958
80000,91,71976.0,661,66.1,8024,71976
100000,91,89927.0,690,69.0,10073,89927
2,92,1.0,1,0.1,1,1
3,92,2.0,1,0.1,1,2
100,92,85.0,46,4.6,15,85
200,92,175.0,84,8.4,25,175
2000,92,1775.0,266,26.6,225,1775
10000,92,8995.0,438,43.8,1005,8995
20000,92,17966.0,497,49.7,2034,17966
40000,92,36000.0,514,51.4,4000,36000
60000,92,54060.0,571,57.1,5940,54060
80000,92,72096.0,612,61.2,7904,72096
100000,92,90069.0,624,62.4,9931,90069
2,93,2.0,1,0.1,0,2
3,93,3.0,1,0.1,0,3
100,93,89.0,50,5.0,11,89
200,93,177.0,91,9.1,23,177
2000,93,1768.0,349,34.9,232,1768
10000,93,8909.0,581,58.1,1091,8909
20000,93,17894.0,643,64.3,2106,17894
40000,93,35869.0,741,74.1,4131,35869
60000,93,53858.0,763,76.3,6142,53858
80000,93,71929.0,767,76.7,8071,71929
100000,93,89938.0,769,76.9,10062,89938
2,94,1.0,1,0.1,1,1
3,94,1.0,1,0.1,2,1
100,94,86.0,46,4.6,14,86
200,94,165.0,90,9.0,35,165
2000,94,1754.0,341,34.1,246,1754
10000,94,8913.0,456,45.6,1087,8913
20000,94,17836.0,528,52.8,2164,17836
40000,94,35838.0,566,56.6,4162,35838
60000,94,53846.0,585,58.5,6154,53846
80000,94,71904.0,598,59.8,8096,71904
100000,94,89885.0,642,64.2,10115,89885
2,95,1.0,1,0.1,1,1
3,95,2.0,1,0.1,1,2
100,95,88.0,45,4.5,12,88
200,95,174.0,81,8.1,26,174
2000,95,1757.0,360,36.0,243,1757
10000,95,8915.0,643,64.3,1085,8915
20000,95,17879.0,709,70.9,2121,17879
40000,95,35892.0,736,73.6,4108,35892
60000,95,53927.0,771,77.1,6073,53927
80000,95,71919.0,781,78.1,8081,71919
100000,95,89885.0,785,78.5,10115,89885
2,96,2.0,1,0.1,0,2
3,96,3.0,1,0.1,0,3
100,96,88.0,48,4.8,12,88
200,96,172.0,89,8.9,28,172
2000,96,1746.0,382,38.2,254,1746
10000,96,8916.0,619,61.9,1084,8916
20000,96,17875.0,732,73.2,2125,17875
40000,96,35812.0,840,84.0,4188,35812
60000,96,53820.0,1019,101.9,6180,53820
80000,96,71816.0,1046,104.6,8184,71816
100000,96,89831.0,1060,106.0,10169,89831
2,97,2.0,1,0.1,0,2
3,97,3.0,1,0.1,0,3
100,97,82.0,45,4.5,18,82
200,97,173.0,82,8.2,27,173
2000,97,1797.0,407,40.7,203,1797
10000,97,8967.0,723,72.3,1033,8967
20000,97,17939.0,1072,107.2,2061,17939
40000,97,35870.0,1281,128.1,4130,35870
60000,97,53844.0,1327,132.7,6156,53844
80000,97,71804.0,1347,134.7,8196,71804
100000,97,89808.0,1376,137.6,10192,89808
2,98,2.0,1,0.1,0,2
3,98,3.0,1,0.1,0,3
100,98,79.0,42,4.2,21,79
200,98,166.0,82,8.2,34,166
2000,98,1763.0,305,30.5,237,1763
10000,98,8953.0,471,47.1,1047,8953
20000,98,17854.0,555,55.5,2146,17854
40000,98,35852.0,638,63.8,4148,35852
60000,98,53940.0,706,70.6,6060,53940
80000,98,71953.0,737,73.7,8047,71953
100000,98,89895.0,755,75.5,10105,89895
2,99,1.0,1,0.1,1,1
3,99,2.0,1,0.1,1,2
100,99,86.0,43,4.3,14,86
200,99,171.0,84,8.4,29,171
2000,99,1753.0,468,46.8,247,1753
10000,99,8955.0,604,60.4,1045,8955
20000,99,18004.0,696,69.6,1996,18004
40000,99,35967.0,802,80.2,4033,35967
60000,99,53976.0,847,84.7,6024,53976
80000,99,72028.0,915,91.5,7972,72028
100000,99,90004.0,928,92.8,9996,90004
2,100,1.0,1,0.1,1,1
3,100,2.0,1,0.1,1,2
100,100,84.0,40,4.0,16,84
200,100,174.0,80,8.0,26,174
2000,100,1764.0,296,29.6,236,1764
10000,100,8937.0,495,49.5,1063,8937
20000,100,17934.0,520,52.0,2066,17934
40000,100,36032.0,540,54.0,3968,36032
60000,100,54068.0,553,55.3,5932,54068
80000,100,71993.0,572,57.2,8007,71993
100000,100,89962.0,618,61.8,10038,89962
