Timestep,Iteration,Total Reward,Suboptimal Arms,Total Regret,Zeros Count,Ones Count
2,1,2.0,1,0.01,0,2
3,1,3.0,1,0.01,0,3
100,1,93.0,50,0.25,7,93
200,1,181.0,104,0.52,19,181
2000,1,1773.0,983,4.91,227,1773
10000,1,8950.0,3974,19.87,1050,8950
20000,1,17937.0,9682,48.41,2063,17937
40000,1,35929.0,13512,67.56,4071,35929
60000,1,53932.0,15624,78.12,6068,53932
80000,1,71918.0,19132,95.66,8082,71918
100000,1,89934.0,26418,132.09,10066,89934
2,2,2.0,1,0.01,0,2
3,2,3.0,1,0.01,0,3
100,2,93.0,50,0.25,7,93
200,2,180.0,102,0.51,20,180
2000,2,1815.0,1168,5.84,185,1815
10000,2,9028.0,5651,28.25,972,9028
20000,2,18011.0,10227,51.14,1989,18011
40000,2,35982.0,16934,84.67,4018,35982
60000,2,53967.0,22845,114.22,6033,53967
80000,2,71854.0,26493,132.46,8146,71854
100000,2,89776.0,36748,183.74,10224,89776
2,3,2.0,1,0.01,0,2
3,3,3.0,1,0.01,0,3
100,3,89.0,50,0.25,11,89
200,3,179.0,102,0.51,21,179
2000,3,1809.0,1023,5.11,191,1809
10000,3,8989.0,4039,20.2,1011,8989
20000,3,17935.0,8024,40.12,2065,17935
40000,3,35882.0,15448,77.24,4118,35882
60000,3,53800.0,24794,123.97,6200,53800
80000,3,71805.0,26777,133.88,8195,71805
100000,3,89823.0,31164,155.82,10177,89823
2,4,1.0,1,0.01,1,1
3,4,2.0,1,0.01,1,2
100,4,86.0,49,0.25,14,86
200,4,177.0,99,0.5,23,177
2000,4,1810.0,1069,5.34,190,1810
10000,4,8970.0,4422,22.11,1030,8970
20000,4,18001.0,6751,33.75,1999,18001
40000,4,35940.0,13695,68.48,4060,35940
60000,4,53879.0,20858,104.29,6121,53879
80000,4,71953.0,21961,109.8,8047,71953
100000,4,89908.0,28744,143.72,10092,89908
2,5,2.0,1,0.01,0,2
3,5,3.0,1,0.01,0,3
100,5,92.0,50,0.25,8,92
200,5,179.0,102,0.51,21,179
2000,5,1794.0,1025,5.12,206,1794
10000,5,8996.0,5541,27.7,1004,8996
20000,5,17957.0,10926,54.63,2043,17957
40000,5,35941.0,15813,79.07,4059,35941
60000,5,53762.0,23948,119.74,6238,53762
80000,5,71628.0,33086,165.43,8372,71628
100000,5,89557.0,49338,246.69,10443,89557
2,6,2.0,1,0.01,0,2
3,6,3.0,1,0.01,0,3
100,6,91.0,50,0.25,9,91
200,6,183.0,103,0.52,17,183
2000,6,1787.0,1073,5.36,213,1787
10000,6,8977.0,5294,26.47,1023,8977
20000,6,17960.0,9617,48.09,2040,17960
40000,6,35845.0,19679,98.39,4155,35845
60000,6,53929.0,21054,105.27,6071,53929
80000,6,71852.0,26867,134.33,8148,71852
100000,6,89853.0,27757,138.78,10147,89853
2,7,2.0,1,0.01,0,2
3,7,2.0,1,0.01,1,2
100,7,90.0,50,0.25,10,90
200,7,186.0,101,0.51,14,186
2000,7,1790.0,1082,5.41,210,1790
10000,7,8943.0,5049,25.24,1057,8943
20000,7,17909.0,10364,51.82,2091,17909
40000,7,35898.0,14670,73.35,4102,35898
60000,7,53864.0,25724,128.62,6136,53864
80000,7,71828.0,29015,145.07,8172,71828
100000,7,89786.0,34145,170.72,10214,89786
2,8,2.0,1,0.01,0,2
3,8,2.0,1,0.01,1,2
100,8,91.0,50,0.25,9,91
200,8,178.0,98,0.49,22,178
2000,8,1792.0,972,4.86,208,1792
10000,8,8999.0,4810,24.05,1001,8999
20000,8,17983.0,8863,44.32,2017,17983
40000,8,35925.0,16652,83.26,4075,35925
60000,8,53842.0,26312,131.56,6158,53842
80000,8,71774.0,34731,173.65,8226,71774
100000,8,89678.0,41761,208.8,10322,89678
2,9,2.0,1,0.01,0,2
3,9,3.0,1,0.01,0,3
100,9,88.0,52,0.26,12,88
200,9,180.0,105,0.53,20,180
2000,9,1802.0,1123,5.61,198,1802
10000,9,9012.0,4811,24.05,988,9012
20000,9,18000.0,8533,42.67,2000,18000
40000,9,35932.0,15342,76.71,4068,35932
60000,9,53860.0,19243,96.21,6140,53860
80000,9,71809.0,24860,124.3,8191,71809
100000,9,89740.0,34662,173.31,10260,89740
2,10,2.0,1,0.01,0,2
3,10,3.0,1,0.01,0,3
100,10,92.0,50,0.25,8,92
200,10,184.0,98,0.49,16,184
2000,10,1819.0,1090,5.45,181,1819
10000,10,9006.0,4767,23.83,994,9006
20000,10,18000.0,9742,48.71,2000,18000
40000,10,35945.0,17635,88.17,4055,35945
60000,10,53894.0,27194,135.97,6106,53894
80000,10,71788.0,32664,163.32,8212,71788
100000,10,89676.0,40749,203.74,10324,89676
2,11,1.0,1,0.01,1,1
3,11,2.0,1,0.01,1,2
100,11,89.0,50,0.25,11,89
200,11,177.0,99,0.5,23,177
2000,11,1807.0,958,4.79,193,1807
10000,11,8984.0,4973,24.86,1016,8984
20000,11,17971.0,8054,40.27,2029,17971
40000,11,35933.0,12257,61.29,4067,35933
60000,11,53892.0,16997,84.98,6108,53892
80000,11,71883.0,20740,103.7,8117,71883
100000,11,89860.0,23735,118.67,10140,89860
2,12,2.0,1,0.01,0,2
3,12,2.0,1,0.01,1,2
100,12,91.0,50,0.25,9,91
200,12,182.0,99,0.5,18,182
2000,12,1783.0,979,4.89,217,1783
10000,12,8942.0,4446,22.23,1058,8942
20000,12,17976.0,6829,34.14,2024,17976
40000,12,35923.0,10629,53.15,4077,35923
60000,12,53908.0,17795,88.97,6092,53908
80000,12,71920.0,20057,100.28,8080,71920
100000,12,89875.0,21535,107.67,10125,89875
2,13,2.0,1,0.01,0,2
3,13,3.0,1,0.01,0,3
100,13,86.0,51,0.26,14,86
200,13,172.0,104,0.52,28,172
2000,13,1789.0,1022,5.11,211,1789
10000,13,8936.0,5438,27.19,1064,8936
20000,13,17923.0,9900,49.5,2077,17923
40000,13,35840.0,16901,84.5,4160,35840
60000,13,53736.0,27777,138.88,6264,53736
80000,13,71674.0,36750,183.75,8326,71674
100000,13,89612.0,45318,226.59,10388,89612
2,14,2.0,1,0.01,0,2
3,14,3.0,1,0.01,0,3
100,14,86.0,49,0.25,14,86
200,14,174.0,100,0.5,26,174
2000,14,1767.0,1016,5.08,233,1767
10000,14,8932.0,4025,20.13,1068,8932
20000,14,17925.0,8189,40.95,2075,17925
40000,14,35940.0,17108,85.54,4060,35940
60000,14,53900.0,22173,110.86,6100,53900
80000,14,71912.0,28055,140.27,8088,71912
100000,14,89873.0,33458,167.29,10127,89873
2,15,1.0,1,0.01,1,1
3,15,2.0,1,0.01,1,2
100,15,94.0,50,0.25,6,94
200,15,184.0,100,0.5,16,184
2000,15,1804.0,985,4.92,196,1804
10000,15,8999.0,4485,22.42,1001,8999
20000,15,17950.0,9931,49.66,2050,17950
40000,15,35935.0,17305,86.52,4065,35935
60000,15,53893.0,23147,115.73,6107,53893
80000,15,71855.0,26512,132.56,8145,71855
100000,15,89985.0,26516,132.58,10015,89985
2,16,2.0,1,0.01,0,2
3,16,3.0,1,0.01,0,3
100,16,91.0,50,0.25,9,91
200,16,182.0,95,0.48,18,182
2000,16,1810.0,819,4.09,190,1810
10000,16,8979.0,4647,23.23,1021,8979
20000,16,18002.0,7583,37.92,1998,18002
40000,16,36007.0,12580,62.9,3993,36007
60000,16,54064.0,16968,84.84,5936,54064
80000,16,72009.0,21254,106.27,7991,72009
100000,16,89994.0,23964,119.82,10006,89994
2,17,2.0,1,0.01,0,2
3,17,3.0,1,0.01,0,3
100,17,92.0,50,0.25,8,92
200,17,176.0,98,0.49,24,176
2000,17,1787.0,1003,5.01,213,1787
10000,17,8993.0,4636,23.18,1007,8993
20000,17,17983.0,8728,43.64,2017,17983
40000,17,35884.0,17019,85.09,4116,35884
60000,17,53820.0,24303,121.51,6180,53820
80000,17,71856.0,35175,175.87,8144,71856
100000,17,89867.0,46694,233.47,10133,89867
2,18,1.0,1,0.01,1,1
3,18,2.0,1,0.01,1,2
100,18,93.0,50,0.25,7,93
200,18,179.0,106,0.53,21,179
2000,18,1786.0,963,4.81,214,1786
10000,18,8989.0,4935,24.67,1011,8989
20000,18,17942.0,8737,43.69,2058,17942
40000,18,35941.0,16577,82.88,4059,35941
60000,18,53921.0,22042,110.21,6079,53921
80000,18,71902.0,26876,134.38,8098,71902
100000,18,89918.0,29570,147.85,10082,89918
2,19,2.0,1,0.01,0,2
3,19,2.0,1,0.01,1,2
100,19,89.0,50,0.25,11,89
200,19,183.0,99,0.5,17,183
2000,19,1776.0,821,4.1,224,1776
10000,19,8969.0,5286,26.43,1031,8969
20000,19,17940.0,10269,51.35,2060,17940
40000,19,35955.0,17134,85.67,4045,35955
60000,19,53906.0,27406,137.03,6094,53906
80000,19,71912.0,29442,147.21,8088,71912
100000,19,89865.0,36788,183.94,10135,89865
2,20,2.0,1,0.01,0,2
3,20,2.0,1,0.01,1,2
100,20,91.0,50,0.25,9,91
200,20,184.0,100,0.5,16,184
2000,20,1803.0,848,4.24,197,1803
10000,20,8955.0,4645,23.22,1045,8955
20000,20,17969.0,6218,31.09,2031,17969
40000,20,35958.0,9911,49.56,4042,35958
60000,20,53998.0,14532,72.66,6002,53998
80000,20,71942.0,25173,125.86,8058,71942
100000,20,89947.0,28076,140.38,10053,89947
2,21,2.0,1,0.01,0,2
3,21,3.0,1,0.01,0,3
100,21,94.0,51,0.26,6,94
200,21,182.0,97,0.49,18,182
2000,21,1808.0,1110,5.55,192,1808
10000,21,8988.0,4046,20.23,1012,8988
20000,21,17955.0,7615,38.08,2045,17955
40000,21,35877.0,13738,68.69,4123,35877
60000,21,53925.0,17036,85.18,6075,53925
80000,21,71860.0,19988,99.94,8140,71860
100000,21,89842.0,23506,117.53,10158,89842
2,22,2.0,1,0.01,0,2
3,22,3.0,1,0.01,0,3
100,22,92.0,50,0.25,8,92
200,22,180.0,98,0.49,20,180
2000,22,1787.0,916,4.58,213,1787
10000,22,8971.0,3497,17.49,1029,8971
20000,22,17925.0,5906,29.53,2075,17925
40000,22,35868.0,10598,52.99,4132,35868
60000,22,53821.0,12515,62.58,6179,53821
80000,22,71796.0,17905,89.52,8204,71796
100000,22,89840.0,18329,91.64,10160,89840
2,23,2.0,1,0.01,0,2
3,23,2.0,1,0.01,1,2
100,23,91.0,50,0.25,9,91
200,23,178.0,98,0.49,22,178
2000,23,1782.0,931,4.65,218,1782
10000,23,8971.0,4297,21.49,1029,8971
20000,23,17987.0,8076,40.38,2013,17987
40000,23,35964.0,13379,66.9,4036,35964
60000,23,53997.0,18051,90.25,6003,53997
80000,23,71992.0,22019,110.09,8008,71992
100000,23,89991.0,23192,115.96,10009,89991
2,24,1.0,1,0.01,1,1
3,24,2.0,2,0.01,1,2
100,24,91.0,51,0.26,9,91
200,24,183.0,99,0.5,17,183
2000,24,1795.0,1174,5.87,205,1795
10000,24,8963.0,5076,25.38,1037,8963
20000,24,17913.0,8033,40.17,2087,17913
40000,24,35860.0,11183,55.92,4140,35860
60000,24,53768.0,16821,84.1,6232,53768
80000,24,71719.0,21606,108.03,8281,71719
100000,24,89678.0,23708,118.54,10322,89678
2,25,2.0,1,0.01,0,2
3,25,2.0,1,0.01,1,2
100,25,89.0,50,0.25,11,89
200,25,181.0,99,0.5,19,181
2000,25,1809.0,921,4.6,191,1809
10000,25,8975.0,5061,25.3,1025,8975
20000,25,17974.0,7633,38.17,2026,17974
40000,25,35950.0,15472,77.36,4050,35950
60000,25,53977.0,21831,109.15,6023,53977
80000,25,71864.0,25549,127.74,8136,71864
100000,25,89758.0,31253,156.26,10242,89758
2,26,2.0,1,0.01,0,2
3,26,3.0,1,0.01,0,3
100,26,92.0,50,0.25,8,92
200,26,184.0,101,0.51,16,184
2000,26,1813.0,1101,5.5,187,1813
10000,26,8982.0,5068,25.34,1018,8982
20000,26,17981.0,10312,51.56,2019,17981
40000,26,35972.0,17741,88.7,4028,35972
60000,26,53930.0,24781,123.9,6070,53930
80000,26,71954.0,28525,142.62,8046,71954
100000,26,89916.0,35088,175.44,10084,89916
2,27,1.0,1,0.01,1,1
3,27,2.0,2,0.01,1,2
100,27,88.0,51,0.26,12,88
200,27,176.0,100,0.5,24,176
2000,27,1777.0,927,4.63,223,1777
10000,27,8897.0,4528,22.64,1103,8897
20000,27,17916.0,6520,32.6,2084,17916
40000,27,35920.0,13768,68.84,4080,35920
60000,27,53895.0,20442,102.21,6105,53895
80000,27,71911.0,31544,157.72,8089,71911
100000,27,89815.0,35075,175.37,10185,89815
2,28,2.0,1,0.01,0,2
3,28,3.0,1,0.01,0,3
100,28,94.0,50,0.25,6,94
200,28,184.0,100,0.5,16,184
2000,28,1793.0,870,4.35,207,1793
10000,28,9015.0,3984,19.92,985,9015
20000,28,17987.0,7280,36.4,2013,17987
40000,28,35987.0,14352,71.76,4013,35987
60000,28,53902.0,19413,97.06,6098,53902
80000,28,71879.0,21221,106.1,8121,71879
100000,28,89908.0,22355,111.77,10092,89908
2,29,2.0,1,0.01,0,2
3,29,3.0,1,0.01,0,3
100,29,91.0,50,0.25,9,91
200,29,180.0,102,0.51,20,180
2000,29,1797.0,937,4.68,203,1797
10000,29,9021.0,5022,25.11,979,9021
20000,29,18020.0,8733,43.67,1980,18020
40000,29,35949.0,15443,77.22,4051,35949
60000,29,53929.0,24856,124.28,6071,53929
80000,29,71852.0,31572,157.86,8148,71852
100000,29,89780.0,35938,179.69,10220,89780
2,30,1.0,1,0.01,1,1
3,30,1.0,1,0.01,2,1
100,30,88.0,49,0.25,12,88
200,30,178.0,97,0.49,22,178
2000,30,1819.0,1012,5.06,181,1819
10000,30,9015.0,4593,22.96,985,9015
20000,30,18008.0,8207,41.04,1992,18008
40000,30,35949.0,15320,76.6,4051,35949
60000,30,53859.0,22770,113.85,6141,53859
80000,30,71810.0,31148,155.74,8190,71810
100000,30,89755.0,38548,192.74,10245,89755
2,31,1.0,1,0.01,1,1
3,31,1.0,1,0.01,2,1
100,31,87.0,50,0.25,13,87
200,31,176.0,106,0.53,24,176
2000,31,1806.0,989,4.94,194,1806
10000,31,9003.0,4278,21.39,997,9003
20000,31,17927.0,6556,32.78,2073,17927
40000,31,35900.0,10880,54.4,4100,35900
60000,31,53915.0,11594,57.97,6085,53915
80000,31,71932.0,13095,65.48,8068,71932
100000,31,89882.0,13710,68.55,10118,89882
2,32,2.0,1,0.01,0,2
3,32,2.0,1,0.01,1,2
100,32,87.0,49,0.25,13,87
200,32,177.0,95,0.48,23,177
2000,32,1792.0,996,4.98,208,1792
10000,32,8976.0,4235,21.18,1024,8976
20000,32,17938.0,6770,33.85,2062,17938
40000,32,35939.0,9739,48.7,4061,35939
60000,32,53937.0,11714,58.57,6063,53937
80000,32,71880.0,18053,90.26,8120,71880
100000,32,89876.0,21594,107.97,10124,89876
2,33,1.0,1,0.01,1,1
3,33,2.0,1,0.01,1,2
100,33,92.0,50,0.25,8,92
200,33,186.0,98,0.49,14,186
2000,33,1807.0,936,4.68,193,1807
10000,33,8991.0,4353,21.76,1009,8991
20000,33,17976.0,8103,40.52,2024,17976
40000,33,35843.0,15244,76.22,4157,35843
60000,33,53924.0,16974,84.87,6076,53924
80000,33,71942.0,24291,121.45,8058,71942
100000,33,89875.0,31337,156.68,10125,89875
2,34,2.0,1,0.01,0,2
3,34,3.0,1,0.01,0,3
100,34,91.0,50,0.25,9,91
200,34,177.0,97,0.49,23,177
2000,34,1789.0,921,4.6,211,1789
10000,34,8941.0,4147,20.74,1059,8941
20000,34,17939.0,9476,47.38,2061,17939
40000,34,35850.0,16629,83.14,4150,35850
60000,34,53817.0,18677,93.38,6183,53817
80000,34,71744.0,26909,134.54,8256,71744
100000,34,89634.0,37679,188.39,10366,89634
2,35,2.0,1,0.01,0,2
3,35,3.0,1,0.01,0,3
100,35,92.0,50,0.25,8,92
200,35,181.0,101,0.51,19,181
2000,35,1822.0,817,4.08,178,1822
10000,35,9022.0,4412,22.06,978,9022
20000,35,17968.0,7761,38.81,2032,17968
40000,35,35950.0,11428,57.14,4050,35950
60000,35,53861.0,14297,71.49,6139,53861
80000,35,71811.0,18571,92.85,8189,71811
100000,35,89795.0,20507,102.53,10205,89795
2,36,2.0,1,0.01,0,2
3,36,3.0,1,0.01,0,3
100,36,90.0,50,0.25,10,90
200,36,180.0,100,0.5,20,180
2000,36,1780.0,954,4.77,220,1780
10000,36,8953.0,4315,21.57,1047,8953
20000,36,17969.0,8984,44.92,2031,17969
40000,36,35919.0,13464,67.32,4081,35919
60000,36,53985.0,14768,73.84,6015,53985
80000,36,71910.0,16944,84.72,8090,71910
100000,36,89921.0,19632,98.16,10079,89921
2,37,2.0,1,0.01,0,2
3,37,3.0,1,0.01,0,3
100,37,92.0,50,0.25,8,92
200,37,181.0,98,0.49,19,181
2000,37,1790.0,1101,5.5,210,1790
10000,37,8953.0,4760,23.8,1047,8953
20000,37,17910.0,7943,39.72,2090,17910
40000,37,35906.0,20683,103.41,4094,35906
60000,37,53787.0,33038,165.19,6213,53787
80000,37,71817.0,37927,189.63,8183,71817
100000,37,89779.0,41466,207.33,10221,89779
2,38,2.0,1,0.01,0,2
3,38,3.0,1,0.01,0,3
100,38,91.0,50,0.25,9,91
200,38,174.0,100,0.5,26,174
2000,38,1796.0,1011,5.05,204,1796
10000,38,8967.0,4134,20.67,1033,8967
20000,38,17973.0,6990,34.95,2027,17973
40000,38,35897.0,10554,52.77,4103,35897
60000,38,53894.0,11858,59.29,6106,53894
80000,38,71812.0,16131,80.65,8188,71812
100000,38,89767.0,17314,86.57,10233,89767
2,39,2.0,1,0.01,0,2
3,39,3.0,1,0.01,0,3
100,39,87.0,50,0.25,13,87
200,39,180.0,102,0.51,20,180
2000,39,1778.0,937,4.68,222,1778
10000,39,8924.0,3588,17.94,1076,8924
20000,39,17896.0,6811,34.05,2104,17896
40000,39,35868.0,12242,61.21,4132,35868
60000,39,53803.0,17408,87.04,6197,53803
80000,39,71785.0,22655,113.27,8215,71785
100000,39,89710.0,29824,149.12,10290,89710
2,40,0.0,1,0.01,2,0
3,40,0.0,1,0.01,3,0
100,40,89.0,51,0.26,11,89
200,40,182.0,103,0.52,18,182
2000,40,1794.0,1088,5.44,206,1794
10000,40,9016.0,5445,27.22,984,9016
20000,40,18007.0,9595,47.98,1993,18007
40000,40,35951.0,17891,89.45,4049,35951
60000,40,54019.0,23869,119.34,5981,54019
80000,40,71985.0,26544,132.72,8015,71985
100000,40,89964.0,29239,146.19,10036,89964
2,41,2.0,1,0.01,0,2
3,41,3.0,1,0.01,0,3
100,41,89.0,49,0.25,11,89
200,41,173.0,99,0.5,27,173
2000,41,1793.0,942,4.71,207,1793
10000,41,8998.0,4884,24.42,1002,8998
20000,41,17996.0,7310,36.55,2004,17996
40000,41,36065.0,10588,52.94,3935,36065
60000,41,54054.0,13398,66.99,5946,54054
80000,41,71992.0,18606,93.03,8008,71992
100000,41,89962.0,21313,106.56,10038,89962
2,42,2.0,1,0.01,0,2
3,42,3.0,1,0.01,0,3
100,42,79.0,49,0.25,21,79
200,42,170.0,99,0.5,30,170
2000,42,1757.0,898,4.49,243,1757
10000,42,8923.0,3929,19.65,1077,8923
20000,42,17924.0,7759,38.8,2076,17924
40000,42,35888.0,11565,57.83,4112,35888
60000,42,53944.0,12196,60.98,6056,53944
80000,42,71897.0,14826,74.13,8103,71897
100000,42,89881.0,18101,90.5,10119,89881
2,43,2.0,1,0.01,0,2
3,43,3.0,1,0.01,0,3
100,43,90.0,50,0.25,10,90
200,43,179.0,99,0.5,21,179
2000,43,1781.0,1159,5.79,219,1781
10000,43,9019.0,4037,20.19,981,9019
20000,43,17941.0,8236,41.18,2059,17941
40000,43,35937.0,16818,84.09,4063,35937
60000,43,53890.0,23595,117.97,6110,53890
80000,43,71864.0,28118,140.59,8136,71864
100000,43,89875.0,29676,148.38,10125,89875
2,44,1.0,1,0.01,1,1
3,44,2.0,2,0.01,1,2
100,44,93.0,50,0.25,7,93
200,44,186.0,97,0.49,14,186
2000,44,1795.0,1076,5.38,205,1795
10000,44,8972.0,4868,24.34,1028,8972
20000,44,17948.0,8585,42.93,2052,17948
40000,44,35885.0,19176,95.88,4115,35885
60000,44,53842.0,27050,135.25,6158,53842
80000,44,71761.0,34733,173.66,8239,71761
100000,44,89816.0,34733,173.66,10184,89816
2,45,2.0,1,0.01,0,2
3,45,3.0,1,0.01,0,3
100,45,86.0,49,0.25,14,86
200,45,176.0,100,0.5,24,176
2000,45,1783.0,1186,5.93,217,1783
10000,45,8966.0,4022,20.11,1034,8966
20000,45,17959.0,8537,42.69,2041,17959
40000,45,35965.0,15197,75.99,4035,35965
60000,45,53976.0,26374,131.87,6024,53976
80000,45,71939.0,32756,163.78,8061,71939
100000,45,89884.0,41084,205.42,10116,89884
2,46,2.0,1,0.01,0,2
3,46,3.0,1,0.01,0,3
100,46,92.0,50,0.25,8,92
200,46,183.0,101,0.51,17,183
2000,46,1807.0,965,4.82,193,1807
10000,46,8953.0,4609,23.04,1047,8953
20000,46,17911.0,10018,50.09,2089,17911
40000,46,35882.0,14060,70.3,4118,35882
60000,46,53788.0,19074,95.37,6212,53788
80000,46,71779.0,24091,120.45,8221,71779
100000,46,89787.0,24177,120.88,10213,89787
2,47,2.0,1,0.01,0,2
3,47,3.0,1,0.01,0,3
100,47,89.0,49,0.25,11,89
200,47,180.0,95,0.48,20,180
2000,47,1800.0,821,4.1,200,1800
10000,47,8982.0,4042,20.21,1018,8982
20000,47,17985.0,7729,38.65,2015,17985
40000,47,35952.0,13398,66.99,4048,35952
60000,47,53941.0,16982,84.91,6059,53941
80000,47,71930.0,21936,109.68,8070,71930
100000,47,89920.0,30869,154.34,10080,89920
2,48,2.0,1,0.01,0,2
3,48,3.0,1,0.01,0,3
100,48,89.0,50,0.25,11,89
200,48,178.0,103,0.52,22,178
2000,48,1778.0,977,4.88,222,1778
10000,48,8946.0,4193,20.97,1054,8946
20000,48,17969.0,6083,30.41,2031,17969
40000,48,35974.0,11815,59.08,4026,35974
60000,48,53890.0,14496,72.48,6110,53890
80000,48,71835.0,19316,96.58,8165,71835
100000,48,89850.0,21477,107.38,10150,89850
2,49,2.0,1,0.01,0,2
3,49,2.0,1,0.01,1,2
100,49,88.0,50,0.25,12,88
200,49,181.0,101,0.51,19,181
2000,49,1792.0,1076,5.38,208,1792
10000,49,8969.0,4793,23.96,1031,8969
20000,49,18015.0,7851,39.26,1985,18015
40000,49,35904.0,11482,57.41,4096,35904
60000,49,53889.0,13116,65.58,6111,53889
80000,49,71890.0,19922,99.61,8110,71890
100000,49,89921.0,22797,113.98,10079,89921
2,50,2.0,1,0.01,0,2
3,50,3.0,1,0.01,0,3
100,50,91.0,50,0.25,9,91
200,50,177.0,99,0.5,23,177
2000,50,1785.0,1056,5.28,215,1785
10000,50,8986.0,4979,24.89,1014,8986
20000,50,17934.0,8790,43.95,2066,17934
40000,50,35810.0,15917,79.59,4190,35810
60000,50,53739.0,21770,108.85,6261,53739
80000,50,71818.0,21770,108.85,8182,71818
100000,50,89855.0,22909,114.54,10145,89855
2,51,2.0,1,0.01,0,2
3,51,2.0,1,0.01,1,2
100,51,86.0,50,0.25,14,86
200,51,176.0,98,0.49,24,176
2000,51,1829.0,1068,5.34,171,1829
10000,51,9012.0,3811,19.06,988,9012
20000,51,18052.0,7621,38.11,1948,18052
40000,51,36023.0,15018,75.09,3977,36023
60000,51,54017.0,18671,93.35,5983,54017
80000,51,71995.0,21484,107.42,8005,71995
100000,51,89929.0,26359,131.79,10071,89929
2,52,2.0,1,0.01,0,2
3,52,3.0,1,0.01,0,3
100,52,89.0,49,0.25,11,89
200,52,179.0,98,0.49,21,179
2000,52,1798.0,820,4.1,202,1798
10000,52,8995.0,3736,18.68,1005,8995
20000,52,17984.0,6474,32.37,2016,17984
40000,52,35914.0,10747,53.74,4086,35914
60000,52,53905.0,15792,78.96,6095,53905
80000,52,71813.0,19667,98.33,8187,71813
100000,52,89840.0,20726,103.63,10160,89840
2,53,2.0,1,0.01,0,2
3,53,3.0,1,0.01,0,3
100,53,90.0,50,0.25,10,90
200,53,179.0,98,0.49,21,179
2000,53,1776.0,914,4.57,224,1776
10000,53,8960.0,4547,22.73,1040,8960
20000,53,17910.0,9405,47.03,2090,17910
40000,53,35914.0,16753,83.76,4086,35914
60000,53,53899.0,21237,106.18,6101,53899
80000,53,71817.0,28135,140.67,8183,71817
100000,53,89760.0,33193,165.96,10240,89760
2,54,1.0,1,0.01,1,1
3,54,2.0,1,0.01,1,2
100,54,88.0,49,0.25,12,88
200,54,175.0,95,0.48,25,175
2000,54,1766.0,1093,5.46,234,1766
10000,54,8965.0,3989,19.95,1035,8965
20000,54,17947.0,9024,45.12,2053,17947
40000,54,35966.0,13911,69.56,4034,35966
60000,54,53925.0,23554,117.77,6075,53925
80000,54,71859.0,30329,151.64,8141,71859
100000,54,89815.0,36073,180.36,10185,89815
2,55,2.0,1,0.01,0,2
3,55,3.0,1,0.01,0,3
100,55,84.0,50,0.25,16,84
200,55,175.0,101,0.51,25,175
2000,55,1767.0,1081,5.4,233,1767
10000,55,8998.0,5988,29.94,1002,8998
20000,55,17958.0,9789,48.95,2042,17958
40000,55,35831.0,18231,91.15,4169,35831
60000,55,53805.0,21309,106.54,6195,53805
80000,55,71825.0,21890,109.45,8175,71825
100000,55,89830.0,22941,114.7,10170,89830
2,56,2.0,1,0.01,0,2
3,56,3.0,1,0.01,0,3
100,56,90.0,50,0.25,10,90
200,56,178.0,101,0.51,22,178
2000,56,1797.0,1160,5.8,203,1797
10000,56,9025.0,5363,26.81,975,9025
20000,56,18043.0,10725,53.63,1957,18043
40000,56,35978.0,17976,89.88,4022,35978
60000,56,53918.0,25804,129.02,6082,53918
80000,56,71828.0,30455,152.27,8172,71828
100000,56,89886.0,30740,153.7,10114,89886
2,57,1.0,1,0.01,1,1
3,57,2.0,1,0.01,1,2
100,57,89.0,51,0.26,11,89
200,57,178.0,103,0.52,22,178
2000,57,1801.0,1102,5.51,199,1801
10000,57,8975.0,4544,22.72,1025,8975
20000,57,17952.0,8668,43.34,2048,17952
40000,57,35988.0,16182,80.91,4012,35988
60000,57,53959.0,18865,94.32,6041,53959
80000,57,71875.0,23085,115.42,8125,71875
100000,57,89900.0,24234,121.17,10100,89900
2,58,2.0,1,0.01,0,2
3,58,3.0,1,0.01,0,3
100,58,89.0,49,0.25,11,89
200,58,182.0,96,0.48,18,182
2000,58,1806.0,825,4.12,194,1806
10000,58,9001.0,4837,24.18,999,9001
20000,58,18006.0,9281,46.41,1994,18006
40000,58,35967.0,15439,77.2,4033,35967
60000,58,53951.0,17629,88.14,6049,53951
80000,58,71916.0,24311,121.55,8084,71916
100000,58,89846.0,28211,141.05,10154,89846
2,59,2.0,1,0.01,0,2
3,59,3.0,1,0.01,0,3
100,59,88.0,51,0.26,12,88
200,59,177.0,101,0.51,23,177
2000,59,1769.0,949,4.74,231,1769
10000,59,8942.0,4576,22.88,1058,8942
20000,59,17964.0,8134,40.67,2036,17964
40000,59,35988.0,16031,80.15,4012,35988
60000,59,53963.0,20174,100.87,6037,53963
80000,59,72029.0,24128,120.64,7971,72029
100000,59,90013.0,27059,135.29,9987,90013
2,60,2.0,1,0.01,0,2
3,60,3.0,1,0.01,0,3
100,60,90.0,50,0.25,10,90
200,60,181.0,102,0.51,19,181
2000,60,1816.0,1121,5.6,184,1816
10000,60,8957.0,5292,26.46,1043,8957
20000,60,17969.0,10847,54.24,2031,17969
40000,60,35908.0,18327,91.63,4092,35908
60000,60,53942.0,20117,100.58,6058,53942
80000,60,71932.0,22424,112.12,8068,71932
100000,60,89924.0,24205,121.02,10076,89924
2,61,2.0,1,0.01,0,2
3,61,3.0,1,0.01,0,3
100,61,89.0,49,0.25,11,89
200,61,178.0,100,0.5,22,178
2000,61,1812.0,924,4.62,188,1812
10000,61,8967.0,4280,21.4,1033,8967
20000,61,17930.0,10231,51.16,2070,17930
40000,61,35874.0,18714,93.57,4126,35874
60000,61,53969.0,22552,112.76,6031,53969
80000,61,71935.0,27335,136.67,8065,71935
100000,61,89875.0,33179,165.89,10125,89875
2,62,2.0,1,0.01,0,2
3,62,3.0,1,0.01,0,3
100,62,93.0,50,0.25,7,93
200,62,186.0,98,0.49,14,186
2000,62,1808.0,1054,5.27,192,1808
10000,62,8980.0,3820,19.1,1020,8980
20000,62,18011.0,8476,42.38,1989,18011
40000,62,35985.0,16385,81.92,4015,35985
60000,62,54006.0,20219,101.09,5994,54006
80000,62,72004.0,21992,109.96,7996,72004
100000,62,90001.0,24629,123.14,9999,90001
2,63,2.0,1,0.01,0,2
3,63,2.0,1,0.01,1,2
100,63,88.0,50,0.25,12,88
200,63,180.0,98,0.49,20,180
2000,63,1812.0,963,4.81,188,1812
10000,63,8907.0,4800,24.0,1093,8907
20000,63,17875.0,8832,44.16,2125,17875
40000,63,35973.0,11759,58.8,4027,35973
60000,63,53920.0,14582,72.91,6080,53920
80000,63,71910.0,16320,81.6,8090,71910
100000,63,89871.0,19922,99.61,10129,89871
2,64,2.0,1,0.01,0,2
3,64,3.0,1,0.01,0,3
100,64,95.0,50,0.25,5,95
200,64,182.0,96,0.48,18,182
2000,64,1810.0,814,4.07,190,1810
10000,64,8980.0,4183,20.92,1020,8980
20000,64,17965.0,6878,34.39,2035,17965
40000,64,35939.0,11812,59.06,4061,35939
60000,64,53912.0,18977,94.88,6088,53912
80000,64,71832.0,24509,122.54,8168,71832
100000,64,89826.0,26128,130.64,10174,89826
2,65,2.0,1,0.01,0,2
3,65,3.0,1,0.01,0,3
100,65,91.0,49,0.25,9,91
200,65,177.0,94,0.47,23,177
2000,65,1788.0,996,4.98,212,1788
10000,65,8962.0,4113,20.57,1038,8962
20000,65,17896.0,7828,39.14,2104,17896
40000,65,35933.0,9523,47.62,4067,35933
60000,65,54004.0,10599,53.0,5996,54004
80000,65,72050.0,11198,55.99,7950,72050
100000,65,89950.0,14401,72.01,10050,89950
2,66,1.0,1,0.01,1,1
3,66,1.0,2,0.01,2,1
100,66,87.0,50,0.25,13,87
200,66,169.0,101,0.51,31,169
2000,66,1773.0,1075,5.37,227,1773
10000,66,8906.0,5473,27.36,1094,8906
20000,66,17865.0,11515,57.58,2135,17865
40000,66,35759.0,18262,91.31,4241,35759
60000,66,53732.0,30901,154.5,6268,53732
80000,66,71599.0,39310,196.55,8401,71599
100000,66,89658.0,40780,203.9,10342,89658
2,67,2.0,1,0.01,0,2
3,67,3.0,1,0.01,0,3
100,67,89.0,49,0.25,11,89
200,67,178.0,97,0.49,22,178
2000,67,1770.0,1015,5.07,230,1770
10000,67,8983.0,6236,31.18,1017,8983
20000,67,17935.0,9944,49.72,2065,17935
40000,67,35932.0,14631,73.16,4068,35932
60000,67,53854.0,19438,97.19,6146,53854
80000,67,71719.0,23002,115.01,8281,71719
100000,67,89624.0,25891,129.45,10376,89624
2,68,2.0,1,0.01,0,2
3,68,3.0,1,0.01,0,3
100,68,90.0,50,0.25,10,90
200,68,174.0,102,0.51,26,174
2000,68,1777.0,1026,5.13,223,1777
10000,68,8951.0,5807,29.03,1049,8951
20000,68,17930.0,9548,47.74,2070,17930
40000,68,35909.0,14944,74.72,4091,35909
60000,68,53902.0,17000,85.0,6098,53902
80000,68,71913.0,18390,91.95,8087,71913
100000,68,89904.0,22036,110.18,10096,89904
2,69,2.0,1,0.01,0,2
3,69,3.0,1,0.01,0,3
100,69,95.0,50,0.25,5,95
200,69,185.0,97,0.49,15,185
2000,69,1812.0,912,4.56,188,1812
10000,69,9021.0,3189,15.95,979,9021
20000,69,17989.0,5905,29.52,2011,17989
40000,69,35950.0,11780,58.9,4050,35950
60000,69,53938.0,14392,71.96,6062,53938
80000,69,71881.0,20356,101.78,8119,71881
100000,69,89887.0,23309,116.54,10113,89887
2,70,2.0,1,0.01,0,2
3,70,2.0,1,0.01,1,2
100,70,95.0,50,0.25,5,95
200,70,187.0,100,0.5,13,187
2000,70,1806.0,1010,5.05,194,1806
10000,70,9006.0,4653,23.26,994,9006
20000,70,17975.0,9434,47.17,2025,17975
40000,70,35879.0,16766,83.83,4121,35879
60000,70,53895.0,19457,97.28,6105,53895
80000,70,71843.0,26645,133.22,8157,71843
100000,70,89867.0,29351,146.75,10133,89867
2,71,2.0,1,0.01,0,2
3,71,3.0,1,0.01,0,3
100,71,90.0,50,0.25,10,90
200,71,180.0,103,0.52,20,180
2000,71,1797.0,1055,5.27,203,1797
10000,71,9036.0,4797,23.98,964,9036
20000,71,18060.0,9129,45.65,1940,18060
40000,71,36130.0,15909,79.55,3870,36130
60000,71,54073.0,20825,104.12,5927,54073
80000,71,72028.0,24777,123.88,7972,72028
100000,71,90021.0,33623,168.11,9979,90021
2,72,1.0,1,0.01,1,1
3,72,2.0,2,0.01,1,2
100,72,88.0,49,0.25,12,88
200,72,177.0,97,0.49,23,177
2000,72,1796.0,1075,5.37,204,1796
10000,72,8977.0,5312,26.56,1023,8977
20000,72,17998.0,9261,46.31,2002,17998
40000,72,36002.0,16860,84.3,3998,36002
60000,72,53888.0,22537,112.68,6112,53888
80000,72,71818.0,28667,143.33,8182,71818
100000,72,89751.0,35983,179.91,10249,89751
2,73,2.0,1,0.01,0,2
3,73,3.0,1,0.01,0,3
100,73,89.0,50,0.25,11,89
200,73,178.0,103,0.52,22,178
2000,73,1782.0,980,4.9,218,1782
10000,73,8992.0,4354,21.77,1008,8992
20000,73,18025.0,6235,31.17,1975,18025
40000,73,35996.0,10529,52.65,4004,35996
60000,73,53939.0,16603,83.01,6061,53939
80000,73,71861.0,23100,115.5,8139,71861
100000,73,89851.0,26204,131.02,10149,89851
2,74,2.0,1,0.01,0,2
3,74,3.0,1,0.01,0,3
100,74,86.0,51,0.26,14,86
200,74,175.0,105,0.53,25,175
2000,74,1810.0,851,4.25,190,1810
10000,74,9013.0,4550,22.75,987,9013
20000,74,18056.0,8887,44.44,1944,18056
40000,74,35966.0,17883,89.41,4034,35966
60000,74,53903.0,27782,138.91,6097,53903
80000,74,71878.0,34685,173.42,8122,71878
100000,74,89886.0,37911,189.55,10114,89886
2,75,2.0,1,0.01,0,2
3,75,3.0,1,0.01,0,3
100,75,92.0,50,0.25,8,92
200,75,172.0,99,0.5,28,172
2000,75,1794.0,988,4.94,206,1794
10000,75,8952.0,4820,24.1,1048,8952
20000,75,17945.0,7645,38.23,2055,17945
40000,75,35895.0,14404,72.02,4105,35895
60000,75,53869.0,18836,94.18,6131,53869
80000,75,71744.0,25488,127.44,8256,71744
100000,75,89810.0,30557,152.78,10190,89810
2,76,1.0,1,0.01,1,1
3,76,2.0,1,0.01,1,2
100,76,92.0,50,0.25,8,92
200,76,180.0,100,0.5,20,180
2000,76,1774.0,1027,5.13,226,1774
10000,76,8968.0,4773,23.86,1032,8968
20000,76,17930.0,6680,33.4,2070,17930
40000,76,35861.0,13888,69.44,4139,35861
60000,76,53835.0,22272,111.36,6165,53835
80000,76,71786.0,23657,118.28,8214,71786
100000,76,89760.0,29881,149.4,10240,89760
2,77,2.0,1,0.01,0,2
3,77,2.0,1,0.01,1,2
100,77,89.0,49,0.25,11,89
200,77,179.0,96,0.48,21,179
2000,77,1805.0,996,4.98,195,1805
10000,77,8981.0,5693,28.46,1019,8981
20000,77,17965.0,8937,44.69,2035,17965
40000,77,35971.0,15301,76.51,4029,35971
60000,77,53935.0,21252,106.26,6065,53935
80000,77,71882.0,31709,158.54,8118,71882
100000,77,89871.0,34800,174.0,10129,89871
2,78,1.0,1,0.01,1,1
3,78,2.0,2,0.01,1,2
100,78,90.0,49,0.25,10,90
200,78,179.0,98,0.49,21,179
2000,78,1816.0,1004,5.02,184,1816
10000,78,9023.0,3826,19.13,977,9023
20000,78,18018.0,5827,29.13,1982,18018
40000,78,36055.0,11751,58.76,3945,36055
60000,78,54011.0,13986,69.93,5989,54011
80000,78,72031.0,15693,78.47,7969,72031
100000,78,90094.0,16177,80.88,9906,90094
2,79,1.0,1,0.01,1,1
3,79,2.0,2,0.01,1,2
100,79,93.0,50,0.25,7,93
200,79,184.0,97,0.49,16,184
2000,79,1785.0,1036,5.18,215,1785
10000,79,8954.0,4715,23.57,1046,8954
20000,79,17892.0,9053,45.27,2108,17892
40000,79,35877.0,12740,63.7,4123,35877
60000,79,53814.0,19381,96.9,6186,53814
80000,79,71815.0,21812,109.06,8185,71815
100000,79,89863.0,23295,116.47,10137,89863
2,80,2.0,1,0.01,0,2
3,80,3.0,1,0.01,0,3
100,80,90.0,51,0.26,10,90
200,80,177.0,100,0.5,23,177
2000,80,1808.0,935,4.67,192,1808
10000,80,9036.0,3212,16.06,964,9036
20000,80,18023.0,6219,31.09,1977,18023
40000,80,35985.0,12676,63.38,4015,35985
60000,80,53924.0,21947,109.73,6076,53924
80000,80,71847.0,34039,170.19,8153,71847
100000,80,89758.0,44972,224.86,10242,89758
2,81,2.0,1,0.01,0,2
3,81,3.0,1,0.01,0,3
100,81,91.0,49,0.25,9,91
200,81,180.0,98,0.49,20,180
2000,81,1770.0,1017,5.08,230,1770
10000,81,8947.0,4535,22.67,1053,8947
20000,81,18001.0,5282,26.41,1999,18001
40000,81,35953.0,12397,61.99,4047,35953
60000,81,54036.0,14361,71.81,5964,54036
80000,81,72024.0,21915,109.57,7976,72024
100000,81,90036.0,33390,166.95,9964,90036
2,82,2.0,1,0.01,0,2
3,82,3.0,1,0.01,0,3
100,82,91.0,50,0.25,9,91
200,82,185.0,97,0.49,15,185
2000,82,1813.0,878,4.39,187,1813
10000,82,9007.0,4357,21.78,993,9007
20000,82,18028.0,6724,33.62,1972,18028
40000,82,36107.0,11676,58.38,3893,36107
60000,82,54043.0,19287,96.43,5957,54043
80000,82,72096.0,24056,120.28,7904,72096
100000,82,90172.0,26863,134.31,9828,90172
2,83,1.0,1,0.01,1,1
3,83,2.0,2,0.01,1,2
100,83,82.0,50,0.25,18,82
200,83,172.0,100,0.5,28,172
2000,83,1782.0,991,4.95,218,1782
10000,83,8928.0,4060,20.3,1072,8928
20000,83,17926.0,7659,38.3,2074,17926
40000,83,35913.0,12373,61.87,4087,35913
60000,83,53854.0,20208,101.04,6146,53854
80000,83,71816.0,23034,115.17,8184,71816
100000,83,89813.0,25028,125.14,10187,89813
2,84,1.0,1,0.01,1,1
3,84,2.0,2,0.01,1,2
100,84,96.0,46,0.23,4,96
200,84,189.0,101,0.51,11,189
2000,84,1781.0,1098,5.49,219,1781
10000,84,8982.0,4637,23.18,1018,8982
20000,84,17976.0,8448,42.24,2024,17976
40000,84,35963.0,16433,82.16,4037,35963
60000,84,53822.0,26101,130.5,6178,53822
80000,84,71842.0,27435,137.17,8158,71842
100000,84,89827.0,32264,161.32,10173,89827
2,85,2.0,1,0.01,0,2
3,85,3.0,1,0.01,0,3
100,85,90.0,50,0.25,10,90
200,85,180.0,102,0.51,20,180
2000,85,1808.0,975,4.87,192,1808
10000,85,8976.0,5016,25.08,1024,8976
20000,85,17932.0,10362,51.81,2068,17932
40000,85,35831.0,16778,83.89,4169,35831
60000,85,53836.0,19510,97.55,6164,53836
80000,85,71793.0,21058,105.29,8207,71793
100000,85,89756.0,24515,122.57,10244,89756
2,86,2.0,1,0.01,0,2
3,86,3.0,1,0.01,0,3
100,86,90.0,50,0.25,10,90
200,86,181.0,105,0.53,19,181
2000,86,1790.0,1004,5.02,210,1790
10000,86,8985.0,4283,21.42,1015,8985
20000,86,17998.0,9117,45.59,2002,17998
40000,86,35940.0,15140,75.7,4060,35940
60000,86,53948.0,20768,103.84,6052,53948
80000,86,71841.0,29637,148.18,8159,71841
100000,86,89809.0,32970,164.85,10191,89809
2,87,1.0,1,0.01,1,1
3,87,2.0,1,0.01,1,2
100,87,94.0,50,0.25,6,94
200,87,190.0,100,0.5,10,190
2000,87,1819.0,909,4.54,181,1819
10000,87,9010.0,3989,19.95,990,9010
20000,87,17968.0,7215,36.08,2032,17968
40000,87,35955.0,15815,79.08,4045,35955
60000,87,53924.0,24467,122.33,6076,53924
80000,87,71824.0,30654,153.27,8176,71824
100000,87,89826.0,37686,188.43,10174,89826
2,88,2.0,1,0.01,0,2
3,88,3.0,1,0.01,0,3
100,88,91.0,50,0.25,9,91
200,88,184.0,99,0.5,16,184
2000,88,1824.0,845,4.22,176,1824
10000,88,8947.0,4646,23.23,1053,8947
20000,88,17914.0,7491,37.46,2086,17914
40000,88,35941.0,9344,46.72,4059,35941
60000,88,53961.0,13716,68.58,6039,53961
80000,88,71900.0,15979,79.89,8100,71900
100000,88,89866.0,20762,103.81,10134,89866
2,89,2.0,1,0.01,0,2
3,89,2.0,1,0.01,1,2
100,89,89.0,50,0.25,11,89
200,89,178.0,102,0.51,22,178
2000,89,1774.0,1141,5.7,226,1774
10000,89,9007.0,4030,20.15,993,9007
20000,89,17952.0,8003,40.02,2048,17952
40000,89,35881.0,14547,72.74,4119,35881
60000,89,53866.0,18598,92.99,6134,53866
80000,89,71822.0,21835,109.17,8178,71822
100000,89,89845.0,23834,119.17,10155,89845
2,90,2.0,1,0.01,0,2
3,90,3.0,1,0.01,0,3
100,90,89.0,50,0.25,11,89
200,90,178.0,100,0.5,22,178
2000,90,1797.0,1062,5.31,203,1797
10000,90,8971.0,4633,23.16,1029,8971
20000,90,17991.0,7419,37.1,2009,17991
40000,90,35986.0,12756,63.78,4014,35986
60000,90,54029.0,14203,71.02,5971,54029
80000,90,72010.0,22534,112.67,7990,72010
100000,90,90038.0,24174,120.87,9962,90038
2,91,2.0,1,0.01,0,2
3,91,3.0,1,0.01,0,3
100,91,88.0,49,0.25,12,88
200,91,176.0,98,0.49,24,176
2000,91,1816.0,659,3.29,184,1816
10000,91,9013.0,4150,20.75,987,9013
20000,91,18044.0,6628,33.14,1956,18044
40000,91,36032.0,12416,62.08,3968,36032
60000,91,54019.0,18930,94.65,5981,54019
80000,91,71978.0,23319,116.59,8022,71978
100000,91,89940.0,29656,148.28,10060,89940
2,92,1.0,1,0.01,1,1
3,92,2.0,1,0.01,1,2
100,92,85.0,48,0.24,15,85
200,92,175.0,101,0.51,25,175
2000,92,1788.0,1060,5.3,212,1788
10000,92,8894.0,4633,23.16,1106,8894
20000,92,17911.0,7835,39.18,2089,17911
40000,92,35881.0,11553,57.77,4119,35881
60000,92,53880.0,14295,71.48,6120,53880
80000,92,71816.0,20118,100.59,8184,71816
100000,92,89801.0,25335,126.67,10199,89801
2,93,2.0,1,0.01,0,2
3,93,3.0,1,0.01,0,3
100,93,86.0,49,0.25,14,86
200,93,174.0,94,0.47,26,174
2000,93,1805.0,828,4.14,195,1805
10000,93,8981.0,3917,19.59,1019,8981
20000,93,17970.0,7474,37.37,2030,17970
40000,93,35934.0,11260,56.3,4066,35934
60000,93,53892.0,15633,78.17,6108,53892
80000,93,71878.0,18164,90.82,8122,71878
100000,93,89816.0,20671,103.35,10184,89816
2,94,2.0,1,0.01,0,2
3,94,3.0,1,0.01,0,3
100,94,92.0,50,0.25,8,92
200,94,182.0,100,0.5,18,182
2000,94,1789.0,1002,5.01,211,1789
10000,94,8907.0,4343,21.71,1093,8907
20000,94,17877.0,10712,53.56,2123,17877
40000,94,35816.0,17189,85.94,4184,35816
60000,94,53791.0,24660,123.3,6209,53791
80000,94,71805.0,33420,167.1,8195,71805
100000,94,89742.0,40697,203.48,10258,89742
2,95,1.0,1,0.01,1,1
3,95,2.0,2,0.01,1,2
100,95,89.0,51,0.26,11,89
200,95,177.0,101,0.51,23,177
2000,95,1800.0,1015,5.07,200,1800
10000,95,8967.0,4788,23.94,1033,8967
20000,95,17962.0,9093,45.47,2038,17962
40000,95,35925.0,15304,76.52,4075,35925
60000,95,53945.0,22054,110.27,6055,53945
80000,95,71881.0,28263,141.31,8119,71881
100000,95,89879.0,35966,179.83,10121,89879
2,96,2.0,1,0.01,0,2
3,96,3.0,1,0.01,0,3
100,96,95.0,50,0.25,5,95
200,96,183.0,101,0.51,17,183
2000,96,1795.0,845,4.22,205,1795
10000,96,9004.0,3463,17.32,996,9004
20000,96,18014.0,6503,32.51,1986,18014
40000,96,35995.0,14285,71.43,4005,35995
60000,96,53950.0,22085,110.42,6050,53950
80000,96,71884.0,31465,157.32,8116,71884
100000,96,89829.0,36242,181.21,10171,89829
2,97,2.0,1,0.01,0,2
3,97,3.0,1,0.01,0,3
100,97,98.0,54,0.27,2,98
200,97,189.0,100,0.5,11,189
2000,97,1797.0,884,4.42,203,1797
10000,97,9002.0,5027,25.13,998,9002
20000,97,17973.0,10450,52.25,2027,17973
40000,97,35959.0,19786,98.93,4041,35959
60000,97,53889.0,28172,140.86,6111,53889
80000,97,71890.0,31004,155.02,8110,71890
100000,97,89902.0,33001,165.0,10098,89902
2,98,2.0,1,0.01,0,2
3,98,2.0,1,0.01,1,2
100,98,84.0,52,0.26,16,84
200,98,173.0,102,0.51,27,173
2000,98,1795.0,798,3.99,205,1795
10000,98,8960.0,4535,22.67,1040,8960
20000,98,17898.0,8383,41.92,2102,17898
40000,98,35843.0,12581,62.91,4157,35843
60000,98,53804.0,17352,86.76,6196,53804
80000,98,71778.0,20533,102.66,8222,71778
100000,98,89718.0,23628,118.14,10282,89718
2,99,2.0,1,0.01,0,2
3,99,3.0,1,0.01,0,3
100,99,85.0,52,0.26,15,85
200,99,179.0,102,0.51,21,179
2000,99,1806.0,1134,5.67,194,1806
10000,99,8986.0,5531,27.65,1014,8986
20000,99,17946.0,9808,49.04,2054,17946
40000,99,35904.0,18187,90.93,4096,35904
60000,99,53862.0,24158,120.79,6138,53862
80000,99,71829.0,30461,152.3,8171,71829
100000,99,89721.0,41111,205.55,10279,89721
2,100,2.0,1,0.01,0,2
3,100,3.0,1,0.01,0,3
100,100,90.0,50,0.25,10,90
200,100,179.0,102,0.51,21,179
2000,100,1782.0,1037,5.18,218,1782
10000,100,8980.0,3931,19.66,1020,8980
20000,100,17962.0,6397,31.98,2038,17962
40000,100,35897.0,12399,62.0,4103,35897
60000,100,53820.0,16503,82.51,6180,53820
80000,100,71769.0,25619,128.09,8231,71769
100000,100,89760.0,31919,159.59,10240,89760
