Timestep,Iteration,Total Reward,Suboptimal Arms,Total Regret,Zeros Count,Ones Count
2,1,1.0,1,0.01,1,1
3,1,1.0,1,0.01,2,1
100,1,53.0,1,0.01,47,53
200,1,91.0,1,0.01,109,91
2000,1,1004.0,1,0.01,996,1004
10000,1,4993.0,1,0.01,5007,4993
20000,1,10039.0,1,0.01,9961,10039
40000,1,19968.0,1,0.01,20032,19968
60000,1,29946.0,1,0.01,30054,29946
80000,1,40121.0,1,0.01,39879,40121
100000,1,50109.0,1,0.01,49891,50109
2,2,1.0,1,0.01,1,1
3,2,2.0,1,0.01,1,2
100,2,45.0,1,0.01,55,45
200,2,90.0,1,0.01,110,90
2000,2,996.0,1,0.01,1004,996
10000,2,4984.0,1,0.01,5016,4984
20000,2,9918.0,1,0.01,10082,9918
40000,2,19947.0,1,0.01,20053,19947
60000,2,30054.0,1,0.01,29946,30054
80000,2,39925.0,1,0.01,40075,39925
100000,2,49951.0,1,0.01,50049,49951
2,3,0.0,1,0.01,2,0
3,3,0.0,1,0.01,3,0
100,3,45.0,5,0.03,55,45
200,3,99.0,5,0.03,101,99
2000,3,1011.0,5,0.03,989,1011
10000,3,4998.0,5,0.03,5002,4998
20000,3,10007.0,5,0.03,9993,10007
40000,3,20039.0,5,0.03,19961,20039
60000,3,30248.0,5,0.03,29752,30248
80000,3,40356.0,5,0.03,39644,40356
100000,3,50329.0,5,0.03,49671,50329
2,4,1.0,1,0.01,1,1
3,4,2.0,2,0.01,1,2
100,4,53.0,99,0.5,47,53
200,4,102.0,199,1.0,98,102
2000,4,968.0,1999,10.0,1032,968
10000,4,4942.0,9999,50.0,5058,4942
20000,4,9950.0,19999,99.99,10050,9950
40000,4,19839.0,39999,199.99,20161,19839
60000,4,29729.0,59999,299.99,30271,29729
80000,4,39567.0,79999,399.99,40433,39567
100000,4,49395.0,99999,499.99,50605,49395
2,5,1.0,1,0.01,1,1
3,5,1.0,1,0.01,2,1
100,5,55.0,1,0.01,45,55
200,5,104.0,1,0.01,96,104
2000,5,997.0,1,0.01,1003,997
10000,5,5038.0,1,0.01,4962,5038
20000,5,9953.0,1,0.01,10047,9953
40000,5,20025.0,1,0.01,19975,20025
60000,5,30081.0,1,0.01,29919,30081
80000,5,39963.0,1,0.01,40037,39963
100000,5,50022.0,1,0.01,49978,50022
2,6,1.0,1,0.01,1,1
3,6,2.0,2,0.01,1,2
100,6,44.0,99,0.5,56,44
200,6,96.0,199,1.0,104,96
2000,6,996.0,1999,10.0,1004,996
10000,6,4957.0,9999,50.0,5043,4957
20000,6,9964.0,19999,99.99,10036,9964
40000,6,19812.0,39999,199.99,20188,19812
60000,6,29749.0,59999,299.99,30251,29749
80000,6,39556.0,79999,399.99,40444,39556
100000,6,49394.0,99999,499.99,50606,49394
2,7,1.0,1,0.01,1,1
3,7,2.0,1,0.01,1,2
100,7,57.0,1,0.01,43,57
200,7,106.0,1,0.01,94,106
2000,7,990.0,1,0.01,1010,990
10000,7,4969.0,1,0.01,5031,4969
20000,7,10079.0,1,0.01,9921,10079
40000,7,19923.0,1,0.01,20077,19923
60000,7,29862.0,1,0.01,30138,29862
80000,7,39846.0,1,0.01,40154,39846
100000,7,49819.0,1,0.01,50181,49819
2,8,1.0,1,0.01,1,1
3,8,1.0,1,0.01,2,1
100,8,40.0,1,0.01,60,40
200,8,88.0,1,0.01,112,88
2000,8,996.0,1,0.01,1004,996
10000,8,4945.0,1,0.01,5055,4945
20000,8,9964.0,1,0.01,10036,9964
40000,8,19948.0,1,0.01,20052,19948
60000,8,29902.0,1,0.01,30098,29902
80000,8,39821.0,1,0.01,40179,39821
100000,8,49782.0,1,0.01,50218,49782
2,9,1.0,1,0.01,1,1
3,9,1.0,2,0.01,2,1
100,9,43.0,99,0.5,57,43
200,9,100.0,199,1.0,100,100
2000,9,1015.0,1999,10.0,985,1015
10000,9,4977.0,9999,50.0,5023,4977
20000,9,9931.0,19999,99.99,10069,9931
40000,9,20007.0,39999,199.99,19993,20007
60000,9,29913.0,59999,299.99,30087,29913
80000,9,39757.0,79999,399.99,40243,39757
100000,9,49730.0,99999,499.99,50270,49730
2,10,0.0,1,0.01,2,0
3,10,0.0,1,0.01,3,0
100,10,42.0,98,0.49,58,42
200,10,86.0,198,0.99,114,86
2000,10,965.0,1998,9.99,1035,965
10000,10,4857.0,9998,49.99,5143,4857
20000,10,9740.0,19998,99.99,10260,9740
40000,10,19591.0,39998,199.99,20409,19591
60000,10,29490.0,59998,299.99,30510,29490
80000,10,39221.0,79998,399.99,40779,39221
100000,10,49246.0,99998,499.99,50754,49246
2,11,1.0,1,0.01,1,1
3,11,2.0,2,0.01,1,2
100,11,51.0,99,0.5,49,51
200,11,103.0,199,1.0,97,103
2000,11,982.0,1999,10.0,1018,982
10000,11,5013.0,9999,50.0,4987,5013
20000,11,10002.0,19999,99.99,9998,10002
40000,11,19943.0,39999,199.99,20057,19943
60000,11,29841.0,59999,299.99,30159,29841
80000,11,39793.0,79999,399.99,40207,39793
100000,11,49748.0,99999,499.99,50252,49748
2,12,0.0,1,0.01,2,0
3,12,0.0,1,0.01,3,0
100,12,50.0,3,0.02,50,50
200,12,94.0,3,0.02,106,94
2000,12,1000.0,3,0.02,1000,1000
10000,12,5079.0,3,0.02,4921,5079
20000,12,10083.0,3,0.02,9917,10083
40000,12,20057.0,3,0.02,19943,20057
60000,12,30047.0,3,0.02,29953,30047
80000,12,40004.0,3,0.02,39996,40004
100000,12,49779.0,3,0.02,50221,49779
2,13,1.0,1,0.01,1,1
3,13,2.0,2,0.01,1,2
100,13,53.0,99,0.5,47,53
200,13,100.0,199,1.0,100,100
2000,13,1011.0,1999,10.0,989,1011
10000,13,4991.0,9999,50.0,5009,4991
20000,13,9934.0,19999,99.99,10066,9934
40000,13,19840.0,39999,199.99,20160,19840
60000,13,29721.0,59999,299.99,30279,29721
80000,13,39512.0,79999,399.99,40488,39512
100000,13,49406.0,99999,499.99,50594,49406
2,14,1.0,1,0.01,1,1
3,14,1.0,2,0.01,2,1
100,14,44.0,99,0.5,56,44
200,14,95.0,199,1.0,105,95
2000,14,980.0,1999,10.0,1020,980
10000,14,5010.0,9999,50.0,4990,5010
20000,14,10041.0,19999,99.99,9959,10041
40000,14,19968.0,39999,199.99,20032,19968
60000,14,29854.0,59999,299.99,30146,29854
80000,14,39667.0,79999,399.99,40333,39667
100000,14,49414.0,99999,499.99,50586,49414
2,15,0.0,1,0.01,2,0
3,15,1.0,1,0.01,2,1
100,15,52.0,97,0.49,48,52
200,15,100.0,197,0.99,100,100
2000,15,992.0,1997,9.99,1008,992
10000,15,5021.0,9997,49.99,4979,5021
20000,15,10007.0,19997,99.98,9993,10007
40000,15,19837.0,39997,199.98,20163,19837
60000,15,29692.0,59997,299.98,30308,29692
80000,15,39592.0,79997,399.98,40408,39592
100000,15,49490.0,99997,499.98,50510,49490
2,16,0.0,1,0.01,2,0
3,16,1.0,1,0.01,2,1
100,16,51.0,2,0.01,49,51
200,16,101.0,2,0.01,99,101
2000,16,992.0,2,0.01,1008,992
10000,16,4986.0,2,0.01,5014,4986
20000,16,9983.0,2,0.01,10017,9983
40000,16,19924.0,2,0.01,20076,19924
60000,16,29910.0,2,0.01,30090,29910
80000,16,39985.0,2,0.01,40015,39985
100000,16,49838.0,2,0.01,50162,49838
2,17,1.0,1,0.01,1,1
3,17,2.0,1,0.01,1,2
100,17,46.0,1,0.01,54,46
200,17,102.0,1,0.01,98,102
2000,17,997.0,1,0.01,1003,997
10000,17,4876.0,1,0.01,5124,4876
20000,17,9876.0,1,0.01,10124,9876
40000,17,19760.0,1,0.01,20240,19760
60000,17,29756.0,1,0.01,30244,29756
80000,17,39703.0,1,0.01,40297,39703
100000,17,49616.0,1,0.01,50384,49616
2,18,0.0,1,0.01,2,0
3,18,0.0,1,0.01,3,0
100,18,45.0,98,0.49,55,45
200,18,88.0,198,0.99,112,88
2000,18,1004.0,1998,9.99,996,1004
10000,18,4934.0,9998,49.99,5066,4934
20000,18,9958.0,19998,99.99,10042,9958
40000,18,19840.0,39998,199.99,20160,19840
60000,18,29805.0,59998,299.99,30195,29805
80000,18,39657.0,79998,399.99,40343,39657
100000,18,49645.0,99998,499.99,50355,49645
2,19,1.0,1,0.01,1,1
3,19,2.0,2,0.01,1,2
100,19,52.0,99,0.5,48,52
200,19,97.0,199,1.0,103,97
2000,19,972.0,1999,10.0,1028,972
10000,19,4865.0,9999,50.0,5135,4865
20000,19,9909.0,19999,99.99,10091,9909
40000,19,19807.0,39999,199.99,20193,19807
60000,19,29723.0,59999,299.99,30277,29723
80000,19,39588.0,79999,399.99,40412,39588
100000,19,49521.0,99999,499.99,50479,49521
2,20,0.0,1,0.01,2,0
3,20,0.0,1,0.01,3,0
100,20,48.0,98,0.49,52,48
200,20,95.0,198,0.99,105,95
2000,20,981.0,1998,9.99,1019,981
10000,20,4922.0,9998,49.99,5078,4922
20000,20,9812.0,19998,99.99,10188,9812
40000,20,19540.0,39998,199.99,20460,19540
60000,20,29445.0,59998,299.99,30555,29445
80000,20,39321.0,79998,399.99,40679,39321
100000,20,49204.0,99998,499.99,50796,49204
2,21,1.0,1,0.01,1,1
3,21,2.0,2,0.01,1,2
100,21,52.0,99,0.5,48,52
200,21,108.0,199,1.0,92,108
2000,21,979.0,1999,10.0,1021,979
10000,21,4876.0,9999,50.0,5124,4876
20000,21,9760.0,19999,99.99,10240,9760
40000,21,19709.0,39999,199.99,20291,19709
60000,21,29694.0,59999,299.99,30306,29694
80000,21,39606.0,79999,399.99,40394,39606
100000,21,49430.0,99999,499.99,50570,49430
2,22,0.0,1,0.01,2,0
3,22,1.0,1,0.01,2,1
100,22,44.0,2,0.01,56,44
200,22,97.0,2,0.01,103,97
2000,22,1034.0,2,0.01,966,1034
10000,22,5117.0,2,0.01,4883,5117
20000,22,10119.0,2,0.01,9881,10119
40000,22,20008.0,2,0.01,19992,20008
60000,22,30000.0,2,0.01,30000,30000
80000,22,39881.0,2,0.01,40119,39881
100000,22,49857.0,2,0.01,50143,49857
2,23,0.0,1,0.01,2,0
3,23,1.0,1,0.01,2,1
100,23,52.0,2,0.01,48,52
200,23,106.0,2,0.01,94,106
2000,23,1009.0,2,0.01,991,1009
10000,23,4960.0,2,0.01,5040,4960
20000,23,9851.0,2,0.01,10149,9851
40000,23,19701.0,2,0.01,20299,19701
60000,23,29549.0,2,0.01,30451,29549
80000,23,39627.0,2,0.01,40373,39627
100000,23,49588.0,2,0.01,50412,49588
2,24,1.0,1,0.01,1,1
3,24,1.0,1,0.01,2,1
100,24,47.0,1,0.01,53,47
200,24,93.0,1,0.01,107,93
2000,24,985.0,1,0.01,1015,985
10000,24,5001.0,1,0.01,4999,5001
20000,24,9928.0,1,0.01,10072,9928
40000,24,19932.0,1,0.01,20068,19932
60000,24,29856.0,1,0.01,30144,29856
80000,24,40013.0,1,0.01,39987,40013
100000,24,49921.0,1,0.01,50079,49921
2,25,1.0,1,0.01,1,1
3,25,2.0,1,0.01,1,2
100,25,50.0,1,0.01,50,50
200,25,105.0,1,0.01,95,105
2000,25,1005.0,1,0.01,995,1005
10000,25,4962.0,1,0.01,5038,4962
20000,25,9996.0,1,0.01,10004,9996
40000,25,19948.0,1,0.01,20052,19948
60000,25,29966.0,1,0.01,30034,29966
80000,25,40015.0,1,0.01,39985,40015
100000,25,49994.0,1,0.01,50006,49994
2,26,2.0,1,0.01,0,2
3,26,3.0,1,0.01,0,3
100,26,44.0,2,0.01,56,44
200,26,88.0,2,0.01,112,88
2000,26,992.0,2,0.01,1008,992
10000,26,5013.0,2,0.01,4987,5013
20000,26,9959.0,2,0.01,10041,9959
40000,26,20011.0,2,0.01,19989,20011
60000,26,29945.0,2,0.01,30055,29945
80000,26,39976.0,2,0.01,40024,39976
100000,26,49988.0,2,0.01,50012,49988
2,27,1.0,1,0.01,1,1
3,27,2.0,2,0.01,1,2
100,27,41.0,99,0.5,59,41
200,27,95.0,199,1.0,105,95
2000,27,962.0,1999,10.0,1038,962
10000,27,4925.0,9999,50.0,5075,4925
20000,27,9840.0,19999,99.99,10160,9840
40000,27,19753.0,39999,199.99,20247,19753
60000,27,29671.0,59999,299.99,30329,29671
80000,27,39528.0,79999,399.99,40472,39528
100000,27,49405.0,99999,499.99,50595,49405
2,28,0.0,1,0.01,2,0
3,28,0.0,1,0.01,3,0
100,28,44.0,98,0.49,56,44
200,28,93.0,198,0.99,107,93
2000,28,988.0,1998,9.99,1012,988
10000,28,4894.0,9998,49.99,5106,4894
20000,28,9809.0,19998,99.99,10191,9809
40000,28,19837.0,39998,199.99,20163,19837
60000,28,29733.0,59998,299.99,30267,29733
80000,28,39600.0,79998,399.99,40400,39600
100000,28,49519.0,99998,499.99,50481,49519
2,29,1.0,1,0.01,1,1
3,29,2.0,1,0.01,1,2
100,29,54.0,1,0.01,46,54
200,29,108.0,1,0.01,92,108
2000,29,1024.0,1,0.01,976,1024
10000,29,4903.0,1,0.01,5097,4903
20000,29,9961.0,1,0.01,10039,9961
40000,29,20002.0,1,0.01,19998,20002
60000,29,29973.0,1,0.01,30027,29973
80000,29,39966.0,1,0.01,40034,39966
100000,29,49994.0,1,0.01,50006,49994
2,30,2.0,1,0.01,0,2
3,30,3.0,1,0.01,0,3
100,30,53.0,2,0.01,47,53
200,30,103.0,2,0.01,97,103
2000,30,1016.0,2,0.01,984,1016
10000,30,4990.0,2,0.01,5010,4990
20000,30,10090.0,2,0.01,9910,10090
40000,30,20157.0,2,0.01,19843,20157
60000,30,30029.0,2,0.01,29971,30029
80000,30,40037.0,2,0.01,39963,40037
100000,30,50064.0,2,0.01,49936,50064
2,31,1.0,1,0.01,1,1
3,31,1.0,2,0.01,2,1
100,31,43.0,99,0.5,57,43
200,31,98.0,199,1.0,102,98
2000,31,951.0,1999,10.0,1049,951
10000,31,4901.0,9999,50.0,5099,4901
20000,31,9827.0,19999,99.99,10173,9827
40000,31,19752.0,39999,199.99,20248,19752
60000,31,29662.0,59999,299.99,30338,29662
80000,31,39472.0,79999,399.99,40528,39472
100000,31,49244.0,99999,499.99,50756,49244
2,32,1.0,1,0.01,1,1
3,32,1.0,2,0.01,2,1
100,32,57.0,99,0.5,43,57
200,32,107.0,199,1.0,93,107
2000,32,1036.0,1999,10.0,964,1036
10000,32,4962.0,9999,50.0,5038,4962
20000,32,9919.0,19999,99.99,10081,9919
40000,32,19854.0,39999,199.99,20146,19854
60000,32,29781.0,59999,299.99,30219,29781
80000,32,39480.0,79999,399.99,40520,39480
100000,32,49320.0,99999,499.99,50680,49320
2,33,2.0,1,0.01,0,2
3,33,2.0,1,0.01,1,2
100,33,51.0,95,0.48,49,51
200,33,100.0,195,0.98,100,100
2000,33,965.0,1995,9.98,1035,965
10000,33,4965.0,9995,49.98,5035,4965
20000,33,9964.0,19995,99.97,10036,9964
40000,33,19841.0,39995,199.97,20159,19841
60000,33,29717.0,59995,299.97,30283,29717
80000,33,39625.0,79995,399.97,40375,39625
100000,33,49468.0,99995,499.97,50532,49468
2,34,1.0,1,0.01,1,1
3,34,2.0,1,0.01,1,2
100,34,57.0,1,0.01,43,57
200,34,107.0,1,0.01,93,107
2000,34,1019.0,1,0.01,981,1019
10000,34,5037.0,1,0.01,4963,5037
20000,34,10053.0,1,0.01,9947,10053
40000,34,20171.0,1,0.01,19829,20171
60000,34,30331.0,1,0.01,29669,30331
80000,34,40333.0,1,0.01,39667,40333
100000,34,50342.0,1,0.01,49658,50342
2,35,1.0,1,0.01,1,1
3,35,1.0,2,0.01,2,1
100,35,44.0,99,0.5,56,44
200,35,101.0,199,1.0,99,101
2000,35,983.0,1999,10.0,1017,983
10000,35,5005.0,9999,50.0,4995,5005
20000,35,9970.0,19999,99.99,10030,9970
40000,35,19773.0,39999,199.99,20227,19773
60000,35,29658.0,59999,299.99,30342,29658
80000,35,39613.0,79999,399.99,40387,39613
100000,35,49450.0,99999,499.99,50550,49450
2,36,1.0,1,0.01,1,1
3,36,1.0,1,0.01,2,1
100,36,51.0,1,0.01,49,51
200,36,108.0,1,0.01,92,108
2000,36,1009.0,1,0.01,991,1009
10000,36,5111.0,1,0.01,4889,5111
20000,36,10176.0,1,0.01,9824,10176
40000,36,20133.0,1,0.01,19867,20133
60000,36,30027.0,1,0.01,29973,30027
80000,36,39987.0,1,0.01,40013,39987
100000,36,50034.0,1,0.01,49966,50034
2,37,0.0,1,0.01,2,0
3,37,0.0,1,0.01,3,0
100,37,56.0,98,0.49,44,56
200,37,108.0,198,0.99,92,108
2000,37,1002.0,1998,9.99,998,1002
10000,37,4939.0,9998,49.99,5061,4939
20000,37,9892.0,19998,99.99,10108,9892
40000,37,19866.0,39998,199.99,20134,19866
60000,37,29919.0,59998,299.99,30081,29919
80000,37,39757.0,79998,399.99,40243,39757
100000,37,49674.0,99998,499.99,50326,49674
2,38,1.0,1,0.01,1,1
3,38,1.0,2,0.01,2,1
100,38,55.0,99,0.5,45,55
200,38,110.0,199,1.0,90,110
2000,38,1003.0,1999,10.0,997,1003
10000,38,4963.0,9999,50.0,5037,4963
20000,38,9932.0,19999,99.99,10068,9932
40000,38,19694.0,39999,199.99,20306,19694
60000,38,29594.0,59999,299.99,30406,29594
80000,38,39598.0,79999,399.99,40402,39598
100000,38,49566.0,99999,499.99,50434,49566
2,39,1.0,1,0.01,1,1
3,39,1.0,2,0.01,2,1
100,39,48.0,99,0.5,52,48
200,39,90.0,199,1.0,110,90
2000,39,1007.0,1999,10.0,993,1007
10000,39,4922.0,9999,50.0,5078,4922
20000,39,9826.0,19999,99.99,10174,9826
40000,39,19720.0,39999,199.99,20280,19720
60000,39,29441.0,59999,299.99,30559,29441
80000,39,39208.0,79999,399.99,40792,39208
100000,39,49060.0,99999,499.99,50940,49060
2,40,1.0,1,0.01,1,1
3,40,1.0,2,0.01,2,1
100,40,43.0,99,0.5,57,43
200,40,90.0,199,1.0,110,90
2000,40,982.0,1999,10.0,1018,982
10000,40,4950.0,9999,50.0,5050,4950
20000,40,9916.0,19999,99.99,10084,9916
40000,40,19774.0,39999,199.99,20226,19774
60000,40,29706.0,59999,299.99,30294,29706
80000,40,39802.0,79999,399.99,40198,39802
100000,40,49664.0,99999,499.99,50336,49664
2,41,1.0,1,0.01,1,1
3,41,2.0,2,0.01,1,2
100,41,46.0,99,0.5,54,46
200,41,106.0,199,1.0,94,106
2000,41,988.0,1999,10.0,1012,988
10000,41,5051.0,9999,50.0,4949,5051
20000,41,10037.0,19999,99.99,9963,10037
40000,41,19834.0,39999,199.99,20166,19834
60000,41,29894.0,59999,299.99,30106,29894
80000,41,39724.0,79999,399.99,40276,39724
100000,41,49713.0,99999,499.99,50287,49713
2,42,0.0,1,0.01,2,0
3,42,1.0,1,0.01,2,1
100,42,47.0,2,0.01,53,47
200,42,88.0,2,0.01,112,88
2000,42,1002.0,2,0.01,998,1002
10000,42,4951.0,2,0.01,5049,4951
20000,42,9973.0,2,0.01,10027,9973
40000,42,20042.0,2,0.01,19958,20042
60000,42,30083.0,2,0.01,29917,30083
80000,42,40024.0,2,0.01,39976,40024
100000,42,50042.0,2,0.01,49958,50042
2,43,2.0,1,0.01,0,2
3,43,2.0,1,0.01,1,2
100,43,43.0,98,0.49,57,43
200,43,88.0,198,0.99,112,88
2000,43,976.0,1998,9.99,1024,976
10000,43,4931.0,9998,49.99,5069,4931
20000,43,9836.0,19998,99.99,10164,9836
40000,43,19688.0,39998,199.99,20312,19688
60000,43,29577.0,59998,299.99,30423,29577
80000,43,39376.0,79998,399.99,40624,39376
100000,43,49315.0,99998,499.99,50685,49315
2,44,1.0,1,0.01,1,1
3,44,2.0,2,0.01,1,2
100,44,56.0,99,0.5,44,56
200,44,97.0,199,1.0,103,97
2000,44,950.0,1999,10.0,1050,950
10000,44,4915.0,9999,50.0,5085,4915
20000,44,9926.0,19999,99.99,10074,9926
40000,44,19814.0,39999,199.99,20186,19814
60000,44,29754.0,59999,299.99,30246,29754
80000,44,39626.0,79999,399.99,40374,39626
100000,44,49556.0,99999,499.99,50444,49556
2,45,1.0,1,0.01,1,1
3,45,2.0,2,0.01,1,2
100,45,48.0,99,0.5,52,48
200,45,96.0,199,1.0,104,96
2000,45,962.0,1999,10.0,1038,962
10000,45,4965.0,9999,50.0,5035,4965
20000,45,9860.0,19999,99.99,10140,9860
40000,45,19821.0,39999,199.99,20179,19821
60000,45,29655.0,59999,299.99,30345,29655
80000,45,39577.0,79999,399.99,40423,39577
100000,45,49522.0,99999,499.99,50478,49522
2,46,2.0,1,0.01,0,2
3,46,3.0,1,0.01,0,3
100,46,42.0,97,0.49,58,42
200,46,96.0,197,0.99,104,96
2000,46,992.0,1997,9.99,1008,992
10000,46,4948.0,9997,49.99,5052,4948
20000,46,9882.0,19997,99.98,10118,9882
40000,46,19877.0,39997,199.98,20123,19877
60000,46,29764.0,59997,299.98,30236,29764
80000,46,39599.0,79997,399.98,40401,39599
100000,46,49423.0,99997,499.98,50577,49423
2,47,2.0,1,0.01,0,2
3,47,3.0,1,0.01,0,3
100,47,39.0,2,0.01,61,39
200,47,82.0,2,0.01,118,82
2000,47,1000.0,2,0.01,1000,1000
10000,47,4982.0,2,0.01,5018,4982
20000,47,9972.0,2,0.01,10028,9972
40000,47,19890.0,2,0.01,20110,19890
60000,47,29791.0,2,0.01,30209,29791
80000,47,39926.0,2,0.01,40074,39926
100000,47,50027.0,2,0.01,49973,50027
2,48,1.0,1,0.01,1,1
3,48,2.0,1,0.01,1,2
100,48,56.0,1,0.01,44,56
200,48,109.0,1,0.01,91,109
2000,48,1005.0,1,0.01,995,1005
10000,48,4935.0,1,0.01,5065,4935
20000,48,10001.0,1,0.01,9999,10001
40000,48,20018.0,1,0.01,19982,20018
60000,48,30056.0,1,0.01,29944,30056
80000,48,39974.0,1,0.01,40026,39974
100000,48,49885.0,1,0.01,50115,49885
2,49,1.0,1,0.01,1,1
3,49,1.0,1,0.01,2,1
100,49,47.0,1,0.01,53,47
200,49,105.0,1,0.01,95,105
2000,49,1000.0,1,0.01,1000,1000
10000,49,5057.0,1,0.01,4943,5057
20000,49,10145.0,1,0.01,9855,10145
40000,49,20234.0,1,0.01,19766,20234
60000,49,30260.0,1,0.01,29740,30260
80000,49,40230.0,1,0.01,39770,40230
100000,49,50253.0,1,0.01,49747,50253
2,50,0.0,1,0.01,2,0
3,50,1.0,1,0.01,2,1
100,50,52.0,2,0.01,48,52
200,50,99.0,2,0.01,101,99
2000,50,1054.0,2,0.01,946,1054
10000,50,5075.0,2,0.01,4925,5075
20000,50,10096.0,2,0.01,9904,10096
40000,50,20071.0,2,0.01,19929,20071
60000,50,30090.0,2,0.01,29910,30090
80000,50,40059.0,2,0.01,39941,40059
100000,50,49953.0,2,0.01,50047,49953
2,51,0.0,1,0.01,2,0
3,51,0.0,1,0.01,3,0
100,51,42.0,98,0.49,58,42
200,51,92.0,198,0.99,108,92
2000,51,991.0,1998,9.99,1009,991
10000,51,5004.0,9998,49.99,4996,5004
20000,51,10016.0,19998,99.99,9984,10016
40000,51,19943.0,39998,199.99,20057,19943
60000,51,29828.0,59998,299.99,30172,29828
80000,51,39824.0,79998,399.99,40176,39824
100000,51,49686.0,99998,499.99,50314,49686
2,52,1.0,1,0.01,1,1
3,52,1.0,2,0.01,2,1
100,52,55.0,99,0.5,45,55
200,52,106.0,199,1.0,94,106
2000,52,1002.0,1999,10.0,998,1002
10000,52,4913.0,9999,50.0,5087,4913
20000,52,9923.0,19999,99.99,10077,9923
40000,52,19847.0,39999,199.99,20153,19847
60000,52,29624.0,59999,299.99,30376,29624
80000,52,39518.0,79999,399.99,40482,39518
100000,52,49419.0,99999,499.99,50581,49419
2,53,1.0,1,0.01,1,1
3,53,1.0,1,0.01,2,1
100,53,51.0,1,0.01,49,51
200,53,106.0,1,0.01,94,106
2000,53,1030.0,1,0.01,970,1030
10000,53,5004.0,1,0.01,4996,5004
20000,53,10081.0,1,0.01,9919,10081
40000,53,20134.0,1,0.01,19866,20134
60000,53,30288.0,1,0.01,29712,30288
80000,53,40205.0,1,0.01,39795,40205
100000,53,50327.0,1,0.01,49673,50327
2,54,0.0,1,0.01,2,0
3,54,1.0,1,0.01,2,1
100,54,58.0,2,0.01,42,58
200,54,119.0,2,0.01,81,119
2000,54,1044.0,2,0.01,956,1044
10000,54,5021.0,2,0.01,4979,5021
20000,54,9996.0,2,0.01,10004,9996
40000,54,20029.0,2,0.01,19971,20029
60000,54,29932.0,2,0.01,30068,29932
80000,54,40011.0,2,0.01,39989,40011
100000,54,49943.0,2,0.01,50057,49943
2,55,1.0,1,0.01,1,1
3,55,2.0,1,0.01,1,2
100,55,58.0,1,0.01,42,58
200,55,110.0,1,0.01,90,110
2000,55,995.0,1,0.01,1005,995
10000,55,4914.0,1,0.01,5086,4914
20000,55,9933.0,1,0.01,10067,9933
40000,55,20049.0,1,0.01,19951,20049
60000,55,30024.0,1,0.01,29976,30024
80000,55,40007.0,1,0.01,39993,40007
100000,55,49942.0,1,0.01,50058,49942
2,56,2.0,1,0.01,0,2
3,56,2.0,1,0.01,1,2
100,56,51.0,98,0.49,49,51
200,56,92.0,198,0.99,108,92
2000,56,1008.0,1998,9.99,992,1008
10000,56,4912.0,9998,49.99,5088,4912
20000,56,9816.0,19998,99.99,10184,9816
40000,56,19773.0,39998,199.99,20227,19773
60000,56,29745.0,59998,299.99,30255,29745
80000,56,39626.0,79998,399.99,40374,39626
100000,56,49560.0,99998,499.99,50440,49560
2,57,0.0,1,0.01,2,0
3,57,1.0,1,0.01,2,1
100,57,57.0,93,0.47,43,57
200,57,107.0,193,0.97,93,107
2000,57,969.0,1993,9.97,1031,969
10000,57,4953.0,9993,49.97,5047,4953
20000,57,9874.0,19993,99.96,10126,9874
40000,57,19847.0,39993,199.96,20153,19847
60000,57,29673.0,59993,299.96,30327,29673
80000,57,39674.0,79993,399.96,40326,39674
100000,57,49515.0,99993,499.96,50485,49515
2,58,0.0,1,0.01,2,0
3,58,1.0,1,0.01,2,1
100,58,44.0,2,0.01,56,44
200,58,95.0,2,0.01,105,95
2000,58,1001.0,2,0.01,999,1001
10000,58,5037.0,2,0.01,4963,5037
20000,58,9955.0,2,0.01,10045,9955
40000,58,19887.0,2,0.01,20113,19887
60000,58,29863.0,2,0.01,30137,29863
80000,58,39806.0,2,0.01,40194,39806
100000,58,49903.0,2,0.01,50097,49903
2,59,1.0,1,0.01,1,1
3,59,2.0,1,0.01,1,2
100,59,51.0,1,0.01,49,51
200,59,99.0,1,0.01,101,99
2000,59,1023.0,1,0.01,977,1023
10000,59,5016.0,1,0.01,4984,5016
20000,59,10000.0,1,0.01,10000,10000
40000,59,20020.0,1,0.01,19980,20020
60000,59,30018.0,1,0.01,29982,30018
80000,59,40096.0,1,0.01,39904,40096
100000,59,50054.0,1,0.01,49946,50054
2,60,0.0,1,0.01,2,0
3,60,1.0,1,0.01,2,1
100,60,55.0,95,0.48,45,55
200,60,105.0,195,0.98,95,105
2000,60,975.0,1995,9.98,1025,975
10000,60,4888.0,9995,49.98,5112,4888
20000,60,9899.0,19995,99.97,10101,9899
40000,60,19632.0,39995,199.97,20368,19632
60000,60,29654.0,59995,299.97,30346,29654
80000,60,39591.0,79995,399.97,40409,39591
100000,60,49603.0,99995,499.97,50397,49603
2,61,1.0,1,0.01,1,1
3,61,1.0,1,0.01,2,1
100,61,60.0,1,0.01,40,60
200,61,112.0,1,0.01,88,112
2000,61,1011.0,1,0.01,989,1011
10000,61,5029.0,1,0.01,4971,5029
20000,61,10016.0,1,0.01,9984,10016
40000,61,19991.0,1,0.01,20009,19991
60000,61,30128.0,1,0.01,29872,30128
80000,61,40224.0,1,0.01,39776,40224
100000,61,50303.0,1,0.01,49697,50303
2,62,1.0,1,0.01,1,1
3,62,2.0,2,0.01,1,2
100,62,52.0,99,0.5,48,52
200,62,105.0,199,1.0,95,105
2000,62,1022.0,1999,10.0,978,1022
10000,62,4956.0,9999,50.0,5044,4956
20000,62,9897.0,19999,99.99,10103,9897
40000,62,19839.0,39999,199.99,20161,19839
60000,62,29815.0,59999,299.99,30185,29815
80000,62,39844.0,79999,399.99,40156,39844
100000,62,49799.0,99999,499.99,50201,49799
2,63,1.0,1,0.01,1,1
3,63,2.0,1,0.01,1,2
100,63,50.0,1,0.01,50,50
200,63,101.0,1,0.01,99,101
2000,63,999.0,1,0.01,1001,999
10000,63,4980.0,1,0.01,5020,4980
20000,63,9949.0,1,0.01,10051,9949
40000,63,19975.0,1,0.01,20025,19975
60000,63,29987.0,1,0.01,30013,29987
80000,63,40017.0,1,0.01,39983,40017
100000,63,50070.0,1,0.01,49930,50070
2,64,2.0,1,0.01,0,2
3,64,2.0,1,0.01,1,2
100,64,45.0,98,0.49,55,45
200,64,98.0,198,0.99,102,98
2000,64,1011.0,1998,9.99,989,1011
10000,64,4981.0,9998,49.99,5019,4981
20000,64,9914.0,19998,99.99,10086,9914
40000,64,19786.0,39998,199.99,20214,19786
60000,64,29732.0,59998,299.99,30268,29732
80000,64,39603.0,79998,399.99,40397,39603
100000,64,49478.0,99998,499.99,50522,49478
2,65,1.0,1,0.01,1,1
3,65,1.0,2,0.01,2,1
100,65,46.0,99,0.5,54,46
200,65,93.0,199,1.0,107,93
2000,65,1022.0,1999,10.0,978,1022
10000,65,4971.0,9999,50.0,5029,4971
20000,65,10009.0,19999,99.99,9991,10009
40000,65,19963.0,39999,199.99,20037,19963
60000,65,29896.0,59999,299.99,30104,29896
80000,65,39923.0,79999,399.99,40077,39923
100000,65,49804.0,99999,499.99,50196,49804
2,66,1.0,1,0.01,1,1
3,66,2.0,1,0.01,1,2
100,66,57.0,1,0.01,43,57
200,66,104.0,1,0.01,96,104
2000,66,1039.0,1,0.01,961,1039
10000,66,4962.0,1,0.01,5038,4962
20000,66,10094.0,1,0.01,9906,10094
40000,66,20086.0,1,0.01,19914,20086
60000,66,30015.0,1,0.01,29985,30015
80000,66,40090.0,1,0.01,39910,40090
100000,66,50108.0,1,0.01,49892,50108
2,67,0.0,1,0.01,2,0
3,67,1.0,1,0.01,2,1
100,67,49.0,2,0.01,51,49
200,67,100.0,2,0.01,100,100
2000,67,1009.0,2,0.01,991,1009
10000,67,5042.0,2,0.01,4958,5042
20000,67,10157.0,2,0.01,9843,10157
40000,67,20197.0,2,0.01,19803,20197
60000,67,30156.0,2,0.01,29844,30156
80000,67,40119.0,2,0.01,39881,40119
100000,67,50119.0,2,0.01,49881,50119
2,68,1.0,1,0.01,1,1
3,68,2.0,2,0.01,1,2
100,68,43.0,99,0.5,57,43
200,68,82.0,199,1.0,118,82
2000,68,956.0,1999,10.0,1044,956
10000,68,4914.0,9999,50.0,5086,4914
20000,68,9898.0,19999,99.99,10102,9898
40000,68,19860.0,39999,199.99,20140,19860
60000,68,29762.0,59999,299.99,30238,29762
80000,68,39713.0,79999,399.99,40287,39713
100000,68,49578.0,99999,499.99,50422,49578
2,69,0.0,1,0.01,2,0
3,69,1.0,1,0.01,2,1
100,69,47.0,97,0.49,53,47
200,69,99.0,197,0.99,101,99
2000,69,962.0,1997,9.99,1038,962
10000,69,4970.0,9997,49.99,5030,4970
20000,69,9901.0,19997,99.98,10099,9901
40000,69,19772.0,39997,199.98,20228,19772
60000,69,29725.0,59997,299.98,30275,29725
80000,69,39636.0,79997,399.98,40364,39636
100000,69,49550.0,99997,499.98,50450,49550
2,70,1.0,1,0.01,1,1
3,70,2.0,1,0.01,1,2
100,70,49.0,1,0.01,51,49
200,70,92.0,1,0.01,108,92
2000,70,1003.0,1,0.01,997,1003
10000,70,4904.0,1,0.01,5096,4904
20000,70,9935.0,1,0.01,10065,9935
40000,70,19875.0,1,0.01,20125,19875
60000,70,29769.0,1,0.01,30231,29769
80000,70,39778.0,1,0.01,40222,39778
100000,70,49757.0,1,0.01,50243,49757
2,71,1.0,1,0.01,1,1
3,71,1.0,2,0.01,2,1
100,71,49.0,99,0.5,51,49
200,71,103.0,199,1.0,97,103
2000,71,998.0,1999,10.0,1002,998
10000,71,5000.0,9999,50.0,5000,5000
20000,71,9985.0,19999,99.99,10015,9985
40000,71,19973.0,39999,199.99,20027,19973
60000,71,29878.0,59999,299.99,30122,29878
80000,71,39701.0,79999,399.99,40299,39701
100000,71,49551.0,99999,499.99,50449,49551
2,72,1.0,1,0.01,1,1
3,72,1.0,1,0.01,2,1
100,72,43.0,1,0.01,57,43
200,72,91.0,1,0.01,109,91
2000,72,996.0,1,0.01,1004,996
10000,72,4979.0,1,0.01,5021,4979
20000,72,9987.0,1,0.01,10013,9987
40000,72,20011.0,1,0.01,19989,20011
60000,72,29915.0,1,0.01,30085,29915
80000,72,39828.0,1,0.01,40172,39828
100000,72,49933.0,1,0.01,50067,49933
2,73,2.0,1,0.01,0,2
3,73,2.0,1,0.01,1,2
100,73,50.0,97,0.49,50,50
200,73,103.0,197,0.99,97,103
2000,73,988.0,1997,9.99,1012,988
10000,73,4935.0,9997,49.99,5065,4935
20000,73,9860.0,19997,99.98,10140,9860
40000,73,19813.0,39997,199.98,20187,19813
60000,73,29604.0,59997,299.98,30396,29604
80000,73,39488.0,79997,399.98,40512,39488
100000,73,49402.0,99997,499.98,50598,49402
2,74,0.0,1,0.01,2,0
3,74,0.0,1,0.01,3,0
100,74,50.0,98,0.49,50,50
200,74,95.0,198,0.99,105,95
2000,74,1007.0,1998,9.99,993,1007
10000,74,5012.0,9998,49.99,4988,5012
20000,74,9835.0,19998,99.99,10165,9835
40000,74,19736.0,39998,199.99,20264,19736
60000,74,29802.0,59998,299.99,30198,29802
80000,74,39660.0,79998,399.99,40340,39660
100000,74,49638.0,99998,499.99,50362,49638
2,75,0.0,1,0.01,2,0
3,75,0.0,1,0.01,3,0
100,75,57.0,97,0.49,43,57
200,75,111.0,197,0.99,89,111
2000,75,1003.0,1997,9.99,997,1003
10000,75,4999.0,9997,49.99,5001,4999
20000,75,9917.0,19997,99.98,10083,9917
40000,75,19843.0,39997,199.98,20157,19843
60000,75,29743.0,59997,299.98,30257,29743
80000,75,39703.0,79997,399.98,40297,39703
100000,75,49741.0,99997,499.98,50259,49741
2,76,2.0,1,0.01,0,2
3,76,2.0,1,0.01,1,2
100,76,50.0,98,0.49,50,50
200,76,93.0,198,0.99,107,93
2000,76,1011.0,1998,9.99,989,1011
10000,76,4960.0,9998,49.99,5040,4960
20000,76,9932.0,19998,99.99,10068,9932
40000,76,19797.0,39998,199.99,20203,19797
60000,76,29742.0,59998,299.99,30258,29742
80000,76,39627.0,79998,399.99,40373,39627
100000,76,49595.0,99998,499.99,50405,49595
2,77,0.0,1,0.01,2,0
3,77,0.0,1,0.01,3,0
100,77,45.0,4,0.02,55,45
200,77,102.0,4,0.02,98,102
2000,77,977.0,4,0.02,1023,977
10000,77,4968.0,4,0.02,5032,4968
20000,77,9977.0,4,0.02,10023,9977
40000,77,20038.0,4,0.02,19962,20038
60000,77,30104.0,4,0.02,29896,30104
80000,77,40039.0,4,0.02,39961,40039
100000,77,50031.0,4,0.02,49969,50031
2,78,1.0,1,0.01,1,1
3,78,2.0,2,0.01,1,2
100,78,48.0,99,0.5,52,48
200,78,96.0,199,1.0,104,96
2000,78,961.0,1999,10.0,1039,961
10000,78,4982.0,9999,50.0,5018,4982
20000,78,9939.0,19999,99.99,10061,9939
40000,78,19847.0,39999,199.99,20153,19847
60000,78,29800.0,59999,299.99,30200,29800
80000,78,39827.0,79999,399.99,40173,39827
100000,78,49722.0,99999,499.99,50278,49722
2,79,0.0,1,0.01,2,0
3,79,1.0,1,0.01,2,1
100,79,52.0,97,0.49,48,52
200,79,100.0,197,0.99,100,100
2000,79,1013.0,1997,9.99,987,1013
10000,79,4987.0,9997,49.99,5013,4987
20000,79,9879.0,19997,99.98,10121,9879
40000,79,19770.0,39997,199.98,20230,19770
60000,79,29717.0,59997,299.98,30283,29717
80000,79,39583.0,79997,399.98,40417,39583
100000,79,49526.0,99997,499.98,50474,49526
2,80,0.0,1,0.01,2,0
3,80,1.0,1,0.01,2,1
100,80,56.0,2,0.01,44,56
200,80,105.0,2,0.01,95,105
2000,80,1033.0,2,0.01,967,1033
10000,80,5007.0,2,0.01,4993,5007
20000,80,10041.0,2,0.01,9959,10041
40000,80,20085.0,2,0.01,19915,20085
60000,80,30131.0,2,0.01,29869,30131
80000,80,40080.0,2,0.01,39920,40080
100000,80,50122.0,2,0.01,49878,50122
2,81,1.0,1,0.01,1,1
3,81,2.0,2,0.01,1,2
100,81,48.0,99,0.5,52,48
200,81,93.0,199,1.0,107,93
2000,81,966.0,1999,10.0,1034,966
10000,81,4933.0,9999,50.0,5067,4933
20000,81,9851.0,19999,99.99,10149,9851
40000,81,19779.0,39999,199.99,20221,19779
60000,81,29656.0,59999,299.99,30344,29656
80000,81,39454.0,79999,399.99,40546,39454
100000,81,49365.0,99999,499.99,50635,49365
2,82,1.0,1,0.01,1,1
3,82,2.0,1,0.01,1,2
100,82,52.0,1,0.01,48,52
200,82,105.0,1,0.01,95,105
2000,82,998.0,1,0.01,1002,998
10000,82,4957.0,1,0.01,5043,4957
20000,82,9944.0,1,0.01,10056,9944
40000,82,19970.0,1,0.01,20030,19970
60000,82,30008.0,1,0.01,29992,30008
80000,82,39973.0,1,0.01,40027,39973
100000,82,50045.0,1,0.01,49955,50045
2,83,1.0,1,0.01,1,1
3,83,1.0,1,0.01,2,1
100,83,47.0,1,0.01,53,47
200,83,96.0,1,0.01,104,96
2000,83,1003.0,1,0.01,997,1003
10000,83,4969.0,1,0.01,5031,4969
20000,83,9969.0,1,0.01,10031,9969
40000,83,20060.0,1,0.01,19940,20060
60000,83,30000.0,1,0.01,30000,30000
80000,83,40057.0,1,0.01,39943,40057
100000,83,50041.0,1,0.01,49959,50041
2,84,0.0,1,0.01,2,0
3,84,1.0,1,0.01,2,1
100,84,45.0,97,0.49,55,45
200,84,98.0,197,0.99,102,98
2000,84,990.0,1997,9.99,1010,990
10000,84,4952.0,9997,49.99,5048,4952
20000,84,9932.0,19997,99.98,10068,9932
40000,84,19879.0,39997,199.98,20121,19879
60000,84,29674.0,59997,299.98,30326,29674
80000,84,39569.0,79997,399.98,40431,39569
100000,84,49492.0,99997,499.98,50508,49492
2,85,1.0,1,0.01,1,1
3,85,2.0,2,0.01,1,2
100,85,44.0,99,0.5,56,44
200,85,90.0,199,1.0,110,90
2000,85,997.0,1999,10.0,1003,997
10000,85,4894.0,9999,50.0,5106,4894
20000,85,9785.0,19999,99.99,10215,9785
40000,85,19751.0,39999,199.99,20249,19751
60000,85,29771.0,59999,299.99,30229,29771
80000,85,39604.0,79999,399.99,40396,39604
100000,85,49466.0,99999,499.99,50534,49466
2,86,1.0,1,0.01,1,1
3,86,2.0,2,0.01,1,2
100,86,65.0,99,0.5,35,65
200,86,120.0,199,1.0,80,120
2000,86,1039.0,1999,10.0,961,1039
10000,86,5084.0,9999,50.0,4916,5084
20000,86,9964.0,19999,99.99,10036,9964
40000,86,19882.0,39999,199.99,20118,19882
60000,86,29830.0,59999,299.99,30170,29830
80000,86,39812.0,79999,399.99,40188,39812
100000,86,49791.0,99999,499.99,50209,49791
2,87,2.0,1,0.01,0,2
3,87,2.0,1,0.01,1,2
100,87,56.0,98,0.49,44,56
200,87,110.0,198,0.99,90,110
2000,87,996.0,1998,9.99,1004,996
10000,87,4977.0,9998,49.99,5023,4977
20000,87,10001.0,19998,99.99,9999,10001
40000,87,19925.0,39998,199.99,20075,19925
60000,87,29870.0,59998,299.99,30130,29870
80000,87,39734.0,79998,399.99,40266,39734
100000,87,49527.0,99998,499.99,50473,49527
2,88,1.0,1,0.01,1,1
3,88,1.0,1,0.01,2,1
100,88,49.0,1,0.01,51,49
200,88,99.0,1,0.01,101,99
2000,88,1024.0,1,0.01,976,1024
10000,88,4928.0,1,0.01,5072,4928
20000,88,9895.0,1,0.01,10105,9895
40000,88,19999.0,1,0.01,20001,19999
60000,88,29979.0,1,0.01,30021,29979
80000,88,40031.0,1,0.01,39969,40031
100000,88,50061.0,1,0.01,49939,50061
2,89,0.0,1,0.01,2,0
3,89,1.0,1,0.01,2,1
100,89,47.0,2,0.01,53,47
200,89,108.0,2,0.01,92,108
2000,89,1032.0,2,0.01,968,1032
10000,89,4938.0,2,0.01,5062,4938
20000,89,9968.0,2,0.01,10032,9968
40000,89,19850.0,2,0.01,20150,19850
60000,89,29813.0,2,0.01,30187,29813
80000,89,39860.0,2,0.01,40140,39860
100000,89,49872.0,2,0.01,50128,49872
2,90,1.0,1,0.01,1,1
3,90,1.0,2,0.01,2,1
100,90,45.0,99,0.5,55,45
200,90,93.0,199,1.0,107,93
2000,90,986.0,1999,10.0,1014,986
10000,90,4996.0,9999,50.0,5004,4996
20000,90,9921.0,19999,99.99,10079,9921
40000,90,19718.0,39999,199.99,20282,19718
60000,90,29580.0,59999,299.99,30420,29580
80000,90,39501.0,79999,399.99,40499,39501
100000,90,49378.0,99999,499.99,50622,49378
2,91,1.0,1,0.01,1,1
3,91,2.0,2,0.01,1,2
100,91,47.0,99,0.5,53,47
200,91,83.0,199,1.0,117,83
2000,91,975.0,1999,10.0,1025,975
10000,91,4991.0,9999,50.0,5009,4991
20000,91,9914.0,19999,99.99,10086,9914
40000,91,19850.0,39999,199.99,20150,19850
60000,91,29763.0,59999,299.99,30237,29763
80000,91,39832.0,79999,399.99,40168,39832
100000,91,49799.0,99999,499.99,50201,49799
2,92,0.0,1,0.01,2,0
3,92,0.0,1,0.01,3,0
100,92,52.0,4,0.02,48,52
200,92,107.0,4,0.02,93,107
2000,92,984.0,4,0.02,1016,984
10000,92,5003.0,4,0.02,4997,5003
20000,92,10043.0,4,0.02,9957,10043
40000,92,20210.0,4,0.02,19790,20210
60000,92,30237.0,4,0.02,29763,30237
80000,92,40145.0,4,0.02,39855,40145
100000,92,50196.0,4,0.02,49804,50196
2,93,1.0,1,0.01,1,1
3,93,2.0,2,0.01,1,2
100,93,53.0,99,0.5,47,53
200,93,99.0,199,1.0,101,99
2000,93,973.0,1999,10.0,1027,973
10000,93,4961.0,9999,50.0,5039,4961
20000,93,9941.0,19999,99.99,10059,9941
40000,93,19757.0,39999,199.99,20243,19757
60000,93,29708.0,59999,299.99,30292,29708
80000,93,39467.0,79999,399.99,40533,39467
100000,93,49267.0,99999,499.99,50733,49267
2,94,2.0,1,0.01,0,2
3,94,2.0,1,0.01,1,2
100,94,54.0,5,0.03,46,54
200,94,106.0,5,0.03,94,106
2000,94,1015.0,5,0.03,985,1015
10000,94,5038.0,5,0.03,4962,5038
20000,94,10110.0,5,0.03,9890,10110
40000,94,19966.0,5,0.03,20034,19966
60000,94,30066.0,5,0.03,29934,30066
80000,94,40080.0,5,0.03,39920,40080
100000,94,50134.0,5,0.03,49866,50134
2,95,2.0,1,0.01,0,2
3,95,2.0,1,0.01,1,2
100,95,50.0,3,0.02,50,50
200,95,99.0,3,0.02,101,99
2000,95,1013.0,3,0.02,987,1013
10000,95,5018.0,3,0.02,4982,5018
20000,95,9957.0,3,0.02,10043,9957
40000,95,20041.0,3,0.02,19959,20041
60000,95,30036.0,3,0.02,29964,30036
80000,95,39989.0,3,0.02,40011,39989
100000,95,50021.0,3,0.02,49979,50021
2,96,1.0,1,0.01,1,1
3,96,2.0,2,0.01,1,2
100,96,48.0,99,0.5,52,48
200,96,98.0,199,1.0,102,98
2000,96,1026.0,1999,10.0,974,1026
10000,96,5018.0,9999,50.0,4982,5018
20000,96,9954.0,19999,99.99,10046,9954
40000,96,19838.0,39999,199.99,20162,19838
60000,96,29530.0,59999,299.99,30470,29530
80000,96,39359.0,79999,399.99,40641,39359
100000,96,49250.0,99999,499.99,50750,49250
2,97,0.0,1,0.01,2,0
3,97,1.0,1,0.01,2,1
100,97,50.0,4,0.02,50,50
200,97,101.0,4,0.02,99,101
2000,97,975.0,4,0.02,1025,975
10000,97,4969.0,4,0.02,5031,4969
20000,97,9996.0,4,0.02,10004,9996
40000,97,19998.0,4,0.02,20002,19998
60000,97,29988.0,4,0.02,30012,29988
80000,97,40064.0,4,0.02,39936,40064
100000,97,49967.0,4,0.02,50033,49967
2,98,2.0,1,0.01,0,2
3,98,3.0,1,0.01,0,3
100,98,52.0,2,0.01,48,52
200,98,101.0,2,0.01,99,101
2000,98,1014.0,2,0.01,986,1014
10000,98,5022.0,2,0.01,4978,5022
20000,98,10022.0,2,0.01,9978,10022
40000,98,20080.0,2,0.01,19920,20080
60000,98,30177.0,2,0.01,29823,30177
80000,98,40183.0,2,0.01,39817,40183
100000,98,50135.0,2,0.01,49865,50135
2,99,1.0,1,0.01,1,1
3,99,2.0,2,0.01,1,2
100,99,48.0,99,0.5,52,48
200,99,96.0,199,1.0,104,96
2000,99,971.0,1999,10.0,1029,971
10000,99,4866.0,9999,50.0,5134,4866
20000,99,9774.0,19999,99.99,10226,9774
40000,99,19630.0,39999,199.99,20370,19630
60000,99,29545.0,59999,299.99,30455,29545
80000,99,39356.0,79999,399.99,40644,39356
100000,99,49277.0,99999,499.99,50723,49277
2,100,2.0,1,0.01,0,2
3,100,2.0,1,0.01,1,2
100,100,44.0,93,0.47,56,44
200,100,92.0,193,0.97,108,92
2000,100,985.0,1993,9.97,1015,985
10000,100,4962.0,9993,49.97,5038,4962
20000,100,9970.0,19993,99.96,10030,9970
40000,100,19795.0,39993,199.96,20205,19795
60000,100,29551.0,59993,299.96,30449,29551
80000,100,39368.0,79993,399.96,40632,39368
100000,100,49225.0,99993,499.96,50775,49225
