Timestep,Iteration,Total Reward,Suboptimal Arms,Total Regret,Zeros Count,Ones Count
2,1,2.0,1,0.1,0,2
3,1,3.0,2,0.2,0,3
100,1,84.0,38,3.8,16,84
200,1,175.0,48,4.8,25,175
2000,1,1793.0,205,20.5,207,1793
10000,1,8993.0,261,26.1,1007,8993
20000,1,18028.0,270,27.0,1972,18028
40000,1,36036.0,294,29.4,3964,36036
60000,1,54021.0,299,29.9,5979,54021
80000,1,72014.0,299,29.9,7986,72014
100000,1,90008.0,299,29.9,9992,90008
2,2,1.0,1,0.1,1,1
3,2,2.0,2,0.2,1,2
100,2,88.0,27,2.7,12,88
200,2,177.0,69,6.9,23,177
2000,2,1806.0,153,15.3,194,1806
10000,2,9042.0,175,17.5,958,9042
20000,2,18043.0,218,21.8,1957,18043
40000,2,36055.0,224,22.4,3945,36055
60000,2,54044.0,226,22.6,5956,54044
80000,2,72048.0,228,22.8,7952,72048
100000,2,90059.0,228,22.8,9941,90059
2,3,2.0,1,0.1,0,2
3,3,3.0,2,0.2,0,3
100,3,88.0,41,4.1,12,88
200,3,178.0,66,6.6,22,178
2000,3,1765.0,147,14.7,235,1765
10000,3,9013.0,151,15.1,987,9013
20000,3,17995.0,193,19.3,2005,17995
40000,3,36059.0,223,22.3,3941,36059
60000,3,53985.0,231,23.1,6015,53985
80000,3,71996.0,233,23.3,8004,71996
100000,3,90007.0,233,23.3,9993,90007
2,4,1.0,1,0.1,1,1
3,4,2.0,2,0.2,1,2
100,4,88.0,32,3.2,12,88
200,4,176.0,50,5.0,24,176
2000,4,1786.0,223,22.3,214,1786
10000,4,9022.0,255,25.5,978,9022
20000,4,18009.0,273,27.3,1991,18009
40000,4,36033.0,277,27.7,3967,36033
60000,4,54064.0,277,27.7,5936,54064
80000,4,72097.0,334,33.4,7903,72097
100000,4,90083.0,334,33.4,9917,90083
2,5,2.0,1,0.1,0,2
3,5,3.0,2,0.2,0,3
100,5,92.0,22,2.2,8,92
200,5,176.0,56,5.6,24,176
2000,5,1797.0,98,9.8,203,1797
10000,5,8996.0,105,10.5,1004,8996
20000,5,17972.0,111,11.1,2028,17972
40000,5,35913.0,114,11.4,4087,35913
60000,5,53918.0,116,11.6,6082,53918
80000,5,71991.0,116,11.6,8009,71991
100000,5,89999.0,116,11.6,10001,89999
2,6,2.0,1,0.1,0,2
3,6,3.0,2,0.2,0,3
100,6,88.0,44,4.4,12,88
200,6,172.0,79,7.9,28,172
2000,6,1781.0,206,20.6,219,1781
10000,6,8965.0,245,24.5,1035,8965
20000,6,17929.0,254,25.4,2071,17929
40000,6,35901.0,255,25.5,4099,35901
60000,6,53897.0,256,25.6,6103,53897
80000,6,71841.0,256,25.6,8159,71841
100000,6,89843.0,256,25.6,10157,89843
2,7,2.0,1,0.1,0,2
3,7,2.0,2,0.2,1,2
100,7,80.0,23,2.3,20,80
200,7,169.0,33,3.3,31,169
2000,7,1793.0,82,8.2,207,1793
10000,7,8984.0,98,9.8,1016,8984
20000,7,18074.0,98,9.8,1926,18074
40000,7,36165.0,105,10.5,3835,36165
60000,7,54088.0,109,10.9,5912,54088
80000,7,72090.0,109,10.9,7910,72090
100000,7,90089.0,110,11.0,9911,90089
2,8,2.0,1,0.1,0,2
3,8,3.0,2,0.2,0,3
100,8,76.0,31,3.1,24,76
200,8,163.0,63,6.3,37,163
2000,8,1743.0,110,11.0,257,1743
10000,8,8970.0,128,12.8,1030,8970
20000,8,17994.0,128,12.8,2006,17994
40000,8,35993.0,131,13.1,4007,35993
60000,8,54019.0,131,13.1,5981,54019
80000,8,72026.0,133,13.3,7974,72026
100000,8,90002.0,133,13.3,9998,90002
2,9,2.0,1,0.1,0,2
3,9,3.0,2,0.2,0,3
100,9,82.0,48,4.8,18,82
200,9,168.0,88,8.8,32,168
2000,9,1776.0,298,29.8,224,1776
10000,9,8952.0,355,35.5,1048,8952
20000,9,17899.0,366,36.6,2101,17899
40000,9,35882.0,368,36.8,4118,35882
60000,9,53898.0,394,39.4,6102,53898
80000,9,71916.0,434,43.4,8084,71916
100000,9,89946.0,437,43.7,10054,89946
2,10,2.0,1,0.1,0,2
3,10,3.0,2,0.2,0,3
100,10,82.0,20,2.0,18,82
200,10,173.0,22,2.2,27,173
2000,10,1776.0,76,7.6,224,1776
10000,10,8975.0,78,7.8,1025,8975
20000,10,17990.0,89,8.9,2010,17990
40000,10,35973.0,89,8.9,4027,35973
60000,10,53986.0,91,9.1,6014,53986
80000,10,71980.0,91,9.1,8020,71980
100000,10,89984.0,91,9.1,10016,89984
2,11,1.0,1,0.1,1,1
3,11,1.0,1,0.1,2,1
100,11,88.0,19,1.9,12,88
200,11,179.0,22,2.2,21,179
2000,11,1784.0,196,19.6,216,1784
10000,11,8985.0,236,23.6,1015,8985
20000,11,17924.0,274,27.4,2076,17924
40000,11,35927.0,276,27.6,4073,35927
60000,11,53913.0,277,27.7,6087,53913
80000,11,71902.0,277,27.7,8098,71902
100000,11,89897.0,277,27.7,10103,89897
2,12,0.0,1,0.1,2,0
3,12,1.0,2,0.2,2,1
100,12,85.0,22,2.2,15,85
200,12,174.0,47,4.7,26,174
2000,12,1762.0,175,17.5,238,1762
10000,12,8937.0,178,17.8,1063,8937
20000,12,18006.0,181,18.1,1994,18006
40000,12,35979.0,182,18.2,4021,35979
60000,12,53964.0,184,18.4,6036,53964
80000,12,71921.0,184,18.4,8079,71921
100000,12,89989.0,184,18.4,10011,89989
2,13,2.0,1,0.1,0,2
3,13,3.0,2,0.2,0,3
100,13,88.0,29,2.9,12,88
200,13,182.0,53,5.3,18,182
2000,13,1778.0,200,20.0,222,1778
10000,13,8920.0,359,35.9,1080,8920
20000,13,17904.0,584,58.4,2096,17904
40000,13,35851.0,657,65.7,4149,35851
60000,13,53804.0,723,72.3,6196,53804
80000,13,71804.0,727,72.7,8196,71804
100000,13,89861.0,727,72.7,10139,89861
2,14,2.0,1,0.1,0,2
3,14,3.0,2,0.2,0,3
100,14,81.0,41,4.1,19,81
200,14,167.0,60,6.0,33,167
2000,14,1799.0,111,11.1,201,1799
10000,14,9006.0,154,15.4,994,9006
20000,14,18001.0,164,16.4,1999,18001
40000,14,36020.0,165,16.5,3980,36020
60000,14,54056.0,165,16.5,5944,54056
80000,14,72053.0,223,22.3,7947,72053
100000,14,90059.0,223,22.3,9941,90059
2,15,2.0,1,0.1,0,2
3,15,3.0,2,0.2,0,3
100,15,85.0,49,4.9,15,85
200,15,168.0,96,9.6,32,168
2000,15,1774.0,232,23.2,226,1774
10000,15,8971.0,290,29.0,1029,8971
20000,15,17994.0,295,29.5,2006,17994
40000,15,35963.0,303,30.3,4037,35963
60000,15,53997.0,303,30.3,6003,53997
80000,15,72001.0,304,30.4,7999,72001
100000,15,89950.0,304,30.4,10050,89950
2,16,1.0,1,0.1,1,1
3,16,2.0,1,0.1,1,2
100,16,85.0,26,2.6,15,85
200,16,168.0,44,4.4,32,168
2000,16,1778.0,228,22.8,222,1778
10000,16,8975.0,270,27.0,1025,8975
20000,16,17923.0,429,42.9,2077,17923
40000,16,35965.0,441,44.1,4035,35965
60000,16,54033.0,441,44.1,5967,54033
80000,16,71976.0,443,44.3,8024,71976
100000,16,89960.0,446,44.6,10040,89960
2,17,2.0,1,0.1,0,2
3,17,3.0,2,0.2,0,3
100,17,83.0,42,4.2,17,83
200,17,175.0,67,6.7,25,175
2000,17,1765.0,317,31.7,235,1765
10000,17,8949.0,683,68.3,1051,8949
20000,17,17883.0,841,84.1,2117,17883
40000,17,35865.0,882,88.2,4135,35865
60000,17,53891.0,883,88.3,6109,53891
80000,17,71903.0,887,88.7,8097,71903
100000,17,89969.0,887,88.7,10031,89969
2,18,1.0,1,0.1,1,1
3,18,2.0,1,0.1,1,2
100,18,88.0,28,2.8,12,88
200,18,177.0,41,4.1,23,177
2000,18,1793.0,368,36.8,207,1793
10000,18,9007.0,489,48.9,993,9007
20000,18,18039.0,493,49.3,1961,18039
40000,18,35976.0,527,52.7,4024,35976
60000,18,53939.0,572,57.2,6061,53939
80000,18,72008.0,572,57.2,7992,72008
100000,18,89935.0,573,57.3,10065,89935
2,19,1.0,1,0.1,1,1
3,19,2.0,2,0.2,1,2
100,19,84.0,50,5.0,16,84
200,19,173.0,112,11.2,27,173
2000,19,1775.0,390,39.0,225,1775
10000,19,8945.0,564,56.4,1055,8945
20000,19,17929.0,598,59.8,2071,17929
40000,19,35822.0,617,61.7,4178,35822
60000,19,53804.0,624,62.4,6196,53804
80000,19,71863.0,624,62.4,8137,71863
100000,19,89891.0,624,62.4,10109,89891
2,20,2.0,1,0.1,0,2
3,20,3.0,2,0.2,0,3
100,20,88.0,41,4.1,12,88
200,20,176.0,69,6.9,24,176
2000,20,1785.0,188,18.8,215,1785
10000,20,8955.0,226,22.6,1045,8955
20000,20,18004.0,229,22.9,1996,18004
40000,20,36000.0,258,25.8,4000,36000
60000,20,53982.0,262,26.2,6018,53982
80000,20,71981.0,263,26.3,8019,71981
100000,20,89953.0,263,26.3,10047,89953
2,21,1.0,1,0.1,1,1
3,21,2.0,1,0.1,1,2
100,21,88.0,33,3.3,12,88
200,21,175.0,54,5.4,25,175
2000,21,1778.0,116,11.6,222,1778
10000,21,8967.0,142,14.2,1033,8967
20000,21,17933.0,172,17.2,2067,17933
40000,21,35889.0,173,17.3,4111,35889
60000,21,53929.0,173,17.3,6071,53929
80000,21,71943.0,173,17.3,8057,71943
100000,21,89954.0,173,17.3,10046,89954
2,22,2.0,1,0.1,0,2
3,22,3.0,2,0.2,0,3
100,22,85.0,28,2.8,15,85
200,22,172.0,41,4.1,28,172
2000,22,1764.0,292,29.2,236,1764
10000,22,8987.0,319,31.9,1013,8987
20000,22,17963.0,331,33.1,2037,17963
40000,22,35968.0,332,33.2,4032,35968
60000,22,54003.0,409,40.9,5997,54003
80000,22,71954.0,411,41.1,8046,71954
100000,22,89977.0,411,41.1,10023,89977
2,23,2.0,1,0.1,0,2
3,23,3.0,2,0.2,0,3
100,23,81.0,48,4.8,19,81
200,23,172.0,81,8.1,28,172
2000,23,1763.0,211,21.1,237,1763
10000,23,8987.0,265,26.5,1013,8987
20000,23,17993.0,289,28.9,2007,17993
40000,23,35931.0,338,33.8,4069,35931
60000,23,53900.0,342,34.2,6100,53900
80000,23,71959.0,342,34.2,8041,71959
100000,23,89933.0,342,34.2,10067,89933
2,24,1.0,1,0.1,1,1
3,24,2.0,2,0.2,1,2
100,24,82.0,37,3.7,18,82
200,24,176.0,62,6.2,24,176
2000,24,1757.0,212,21.2,243,1757
10000,24,8922.0,225,22.5,1078,8922
20000,24,17908.0,227,22.7,2092,17908
40000,24,35903.0,230,23.0,4097,35903
60000,24,53933.0,230,23.0,6067,53933
80000,24,71882.0,234,23.4,8118,71882
100000,24,89936.0,239,23.9,10064,89936
2,25,2.0,1,0.1,0,2
3,25,3.0,2,0.2,0,3
100,25,78.0,42,4.2,22,78
200,25,162.0,77,7.7,38,162
2000,25,1794.0,225,22.5,206,1794
10000,25,8938.0,417,41.7,1062,8938
20000,25,17925.0,446,44.6,2075,17925
40000,25,35905.0,461,46.1,4095,35905
60000,25,53900.0,462,46.2,6100,53900
80000,25,71945.0,462,46.2,8055,71945
100000,25,89946.0,468,46.8,10054,89946
2,26,1.0,1,0.1,1,1
3,26,1.0,2,0.2,2,1
100,26,81.0,44,4.4,19,81
200,26,168.0,71,7.1,32,168
2000,26,1779.0,141,14.1,221,1779
10000,26,8950.0,204,20.4,1050,8950
20000,26,17984.0,206,20.6,2016,17984
40000,26,36008.0,214,21.4,3992,36008
60000,26,54010.0,216,21.6,5990,54010
80000,26,71987.0,216,21.6,8013,71987
100000,26,89937.0,217,21.7,10063,89937
2,27,2.0,1,0.1,0,2
3,27,3.0,2,0.2,0,3
100,27,85.0,25,2.5,15,85
200,27,176.0,55,5.5,24,176
2000,27,1794.0,131,13.1,206,1794
10000,27,8949.0,161,16.1,1051,8949
20000,27,17963.0,162,16.2,2037,17963
40000,27,35954.0,164,16.4,4046,35954
60000,27,54029.0,164,16.4,5971,54029
80000,27,72016.0,166,16.6,7984,72016
100000,27,90062.0,166,16.6,9938,90062
2,28,2.0,1,0.1,0,2
3,28,3.0,2,0.2,0,3
100,28,85.0,40,4.0,15,85
200,28,174.0,59,5.9,26,174
2000,28,1777.0,137,13.7,223,1777
10000,28,8965.0,314,31.4,1035,8965
20000,28,17987.0,372,37.2,2013,17987
40000,28,36034.0,490,49.0,3966,36034
60000,28,53981.0,513,51.3,6019,53981
80000,28,71979.0,516,51.6,8021,71979
100000,28,90066.0,516,51.6,9934,90066
2,29,2.0,1,0.1,0,2
3,29,2.0,2,0.2,1,2
100,29,85.0,36,3.6,15,85
200,29,174.0,47,4.7,26,174
2000,29,1795.0,96,9.6,205,1795
10000,29,8954.0,207,20.7,1046,8954
20000,29,17987.0,322,32.2,2013,17987
40000,29,36033.0,335,33.5,3967,36033
60000,29,53916.0,360,36.0,6084,53916
80000,29,71973.0,361,36.1,8027,71973
100000,29,89982.0,361,36.1,10018,89982
2,30,2.0,1,0.1,0,2
3,30,3.0,2,0.2,0,3
100,30,91.0,38,3.8,9,91
200,30,182.0,62,6.2,18,182
2000,30,1818.0,128,12.8,182,1818
10000,30,9059.0,325,32.5,941,9059
20000,30,18041.0,334,33.4,1959,18041
40000,30,36057.0,337,33.7,3943,36057
60000,30,54111.0,411,41.1,5889,54111
80000,30,72105.0,420,42.0,7895,72105
100000,30,90082.0,441,44.1,9918,90082
2,31,1.0,1,0.1,1,1
3,31,2.0,1,0.1,1,2
100,31,90.0,29,2.9,10,90
200,31,174.0,43,4.3,26,174
2000,31,1771.0,129,12.9,229,1771
10000,31,8972.0,150,15.0,1028,8972
20000,31,17908.0,165,16.5,2092,17908
40000,31,35839.0,172,17.2,4161,35839
60000,31,53788.0,172,17.2,6212,53788
80000,31,71804.0,172,17.2,8196,71804
100000,31,89824.0,172,17.2,10176,89824
2,32,2.0,1,0.1,0,2
3,32,2.0,2,0.2,1,2
100,32,82.0,32,3.2,18,82
200,32,171.0,49,4.9,29,171
2000,32,1773.0,138,13.8,227,1773
10000,32,8970.0,175,17.5,1030,8970
20000,32,17918.0,216,21.6,2082,17918
40000,32,35915.0,275,27.5,4085,35915
60000,32,53868.0,278,27.8,6132,53868
80000,32,71776.0,280,28.0,8224,71776
100000,32,89765.0,280,28.0,10235,89765
2,33,1.0,1,0.1,1,1
3,33,2.0,1,0.1,1,2
100,33,83.0,31,3.1,17,83
200,33,172.0,41,4.1,28,172
2000,33,1780.0,207,20.7,220,1780
10000,33,8951.0,231,23.1,1049,8951
20000,33,17980.0,238,23.8,2020,17980
40000,33,35990.0,312,31.2,4010,35990
60000,33,53943.0,329,32.9,6057,53943
80000,33,71931.0,329,32.9,8069,71931
100000,33,89924.0,329,32.9,10076,89924
2,34,2.0,1,0.1,0,2
3,34,3.0,2,0.2,0,3
100,34,86.0,28,2.8,14,86
200,34,168.0,43,4.3,32,168
2000,34,1786.0,100,10.0,214,1786
10000,34,9037.0,111,11.1,963,9037
20000,34,18016.0,118,11.8,1984,18016
40000,34,36069.0,119,11.9,3931,36069
60000,34,54044.0,119,11.9,5956,54044
80000,34,72029.0,119,11.9,7971,72029
100000,34,90060.0,298,29.8,9940,90060
2,35,2.0,1,0.1,0,2
3,35,3.0,2,0.2,0,3
100,35,87.0,41,4.1,13,87
200,35,171.0,51,5.1,29,171
2000,35,1774.0,167,16.7,226,1774
10000,35,8968.0,299,29.9,1032,8968
20000,35,17983.0,371,37.1,2017,17983
40000,35,36012.0,394,39.4,3988,36012
60000,35,54012.0,395,39.5,5988,54012
80000,35,71958.0,397,39.7,8042,71958
100000,35,89961.0,397,39.7,10039,89961
2,36,1.0,1,0.1,1,1
3,36,2.0,1,0.1,1,2
100,36,89.0,42,4.2,11,89
200,36,178.0,79,7.9,22,178
2000,36,1798.0,188,18.8,202,1798
10000,36,9024.0,245,24.5,976,9024
20000,36,18020.0,249,24.9,1980,18020
40000,36,36004.0,260,26.0,3996,36004
60000,36,54002.0,262,26.2,5998,54002
80000,36,71959.0,263,26.3,8041,71959
100000,36,89991.0,263,26.3,10009,89991
2,37,1.0,1,0.1,1,1
3,37,2.0,1,0.1,1,2
100,37,86.0,32,3.2,14,86
200,37,171.0,50,5.0,29,171
2000,37,1808.0,75,7.5,192,1808
10000,37,8958.0,193,19.3,1042,8958
20000,37,17982.0,195,19.5,2018,17982
40000,37,36004.0,199,19.9,3996,36004
60000,37,54051.0,199,19.9,5949,54051
80000,37,72048.0,199,19.9,7952,72048
100000,37,90058.0,215,21.5,9942,90058
2,38,2.0,1,0.1,0,2
3,38,3.0,2,0.2,0,3
100,38,87.0,24,2.4,13,87
200,38,171.0,50,5.0,29,171
2000,38,1785.0,175,17.5,215,1785
10000,38,8981.0,194,19.4,1019,8981
20000,38,17936.0,273,27.3,2064,17936
40000,38,35900.0,279,27.9,4100,35900
60000,38,53901.0,279,27.9,6099,53901
80000,38,71943.0,279,27.9,8057,71943
100000,38,90017.0,279,27.9,9983,90017
2,39,2.0,1,0.1,0,2
3,39,2.0,2,0.2,1,2
100,39,88.0,20,2.0,12,88
200,39,177.0,36,3.6,23,177
2000,39,1770.0,148,14.8,230,1770
10000,39,8961.0,183,18.3,1039,8961
20000,39,17955.0,187,18.7,2045,17955
40000,39,35917.0,200,20.0,4083,35917
60000,39,53906.0,202,20.2,6094,53906
80000,39,71924.0,202,20.2,8076,71924
100000,39,89914.0,202,20.2,10086,89914
2,40,1.0,1,0.1,1,1
3,40,2.0,1,0.1,1,2
100,40,85.0,34,3.4,15,85
200,40,168.0,75,7.5,32,168
2000,40,1764.0,117,11.7,236,1764
10000,40,8977.0,122,12.2,1023,8977
20000,40,17937.0,254,25.4,2063,17937
40000,40,35956.0,257,25.7,4044,35956
60000,40,53963.0,259,25.9,6037,53963
80000,40,71950.0,259,25.9,8050,71950
100000,40,89959.0,259,25.9,10041,89959
2,41,2.0,1,0.1,0,2
3,41,3.0,2,0.2,0,3
100,41,87.0,31,3.1,13,87
200,41,177.0,64,6.4,23,177
2000,41,1775.0,275,27.5,225,1775
10000,41,8943.0,348,34.8,1057,8943
20000,41,17938.0,353,35.3,2062,17938
40000,41,35960.0,416,41.6,4040,35960
60000,41,53988.0,418,41.8,6012,53988
80000,41,71953.0,548,54.8,8047,71953
100000,41,89929.0,550,55.0,10071,89929
2,42,2.0,1,0.1,0,2
3,42,3.0,2,0.2,0,3
100,42,79.0,34,3.4,21,79
200,42,160.0,72,7.2,40,160
2000,42,1757.0,321,32.1,243,1757
10000,42,8941.0,412,41.2,1059,8941
20000,42,17888.0,443,44.3,2112,17888
40000,42,35937.0,443,44.3,4063,35937
60000,42,53890.0,447,44.7,6110,53890
80000,42,71937.0,447,44.7,8063,71937
100000,42,89963.0,447,44.7,10037,89963
2,43,2.0,1,0.1,0,2
3,43,3.0,2,0.2,0,3
100,43,82.0,54,5.4,18,82
200,43,165.0,96,9.6,35,165
2000,43,1791.0,232,23.2,209,1791
10000,43,8972.0,312,31.2,1028,8972
20000,43,17970.0,315,31.5,2030,17970
40000,43,36035.0,316,31.6,3965,36035
60000,43,54016.0,349,34.9,5984,54016
80000,43,71988.0,350,35.0,8012,71988
100000,43,90023.0,350,35.0,9977,90023
2,44,1.0,1,0.1,1,1
3,44,2.0,1,0.1,1,2
100,44,83.0,33,3.3,17,83
200,44,175.0,48,4.8,25,175
2000,44,1768.0,126,12.6,232,1768
10000,44,9002.0,140,14.0,998,9002
20000,44,17981.0,225,22.5,2019,17981
40000,44,36021.0,237,23.7,3979,36021
60000,44,53989.0,237,23.7,6011,53989
80000,44,72001.0,240,24.0,7999,72001
100000,44,90015.0,240,24.0,9985,90015
2,45,1.0,1,0.1,1,1
3,45,2.0,1,0.1,1,2
100,45,89.0,30,3.0,11,89
200,45,175.0,45,4.5,25,175
2000,45,1784.0,179,17.9,216,1784
10000,45,9002.0,234,23.4,998,9002
20000,45,18006.0,287,28.7,1994,18006
40000,45,36035.0,328,32.8,3965,36035
60000,45,54063.0,330,33.0,5937,54063
80000,45,72111.0,330,33.0,7889,72111
100000,45,90066.0,332,33.2,9934,90066
2,46,2.0,1,0.1,0,2
3,46,3.0,2,0.2,0,3
100,46,87.0,43,4.3,13,87
200,46,172.0,77,7.7,28,172
2000,46,1776.0,147,14.7,224,1776
10000,46,8921.0,317,31.7,1079,8921
20000,46,17913.0,320,32.0,2087,17913
40000,46,35868.0,341,34.1,4132,35868
60000,46,53786.0,376,37.6,6214,53786
80000,46,71728.0,522,52.2,8272,71728
100000,46,89720.0,522,52.2,10280,89720
2,47,2.0,1,0.1,0,2
3,47,3.0,2,0.2,0,3
100,47,88.0,38,3.8,12,88
200,47,177.0,58,5.8,23,177
2000,47,1768.0,250,25.0,232,1768
10000,47,8999.0,430,43.0,1001,8999
20000,47,18009.0,444,44.4,1991,18009
40000,47,35988.0,473,47.3,4012,35988
60000,47,53947.0,474,47.4,6053,53947
80000,47,71923.0,480,48.0,8077,71923
100000,47,89991.0,480,48.0,10009,89991
2,48,2.0,1,0.1,0,2
3,48,2.0,2,0.2,1,2
100,48,90.0,23,2.3,10,90
200,48,176.0,37,3.7,24,176
2000,48,1774.0,91,9.1,226,1774
10000,48,8981.0,104,10.4,1019,8981
20000,48,17927.0,216,21.6,2073,17927
40000,48,35939.0,241,24.1,4061,35939
60000,48,53916.0,241,24.1,6084,53916
80000,48,71969.0,241,24.1,8031,71969
100000,48,90028.0,241,24.1,9972,90028
2,49,2.0,1,0.1,0,2
3,49,2.0,2,0.2,1,2
100,49,80.0,24,2.4,20,80
200,49,175.0,25,2.5,25,175
2000,49,1782.0,188,18.8,218,1782
10000,49,8968.0,249,24.9,1032,8968
20000,49,17988.0,253,25.3,2012,17988
40000,49,35959.0,282,28.2,4041,35959
60000,49,53974.0,282,28.2,6026,53974
80000,49,71998.0,286,28.6,8002,71998
100000,49,89968.0,288,28.8,10032,89968
2,50,2.0,1,0.1,0,2
3,50,3.0,2,0.2,0,3
100,50,87.0,39,3.9,13,87
200,50,177.0,46,4.6,23,177
2000,50,1782.0,188,18.8,218,1782
10000,50,9037.0,300,30.0,963,9037
20000,50,18023.0,318,31.8,1977,18023
40000,50,36006.0,320,32.0,3994,36006
60000,50,53965.0,322,32.2,6035,53965
80000,50,71966.0,330,33.0,8034,71966
100000,50,89913.0,330,33.0,10087,89913
2,51,2.0,1,0.1,0,2
3,51,3.0,2,0.2,0,3
100,51,82.0,29,2.9,18,82
200,51,171.0,63,6.3,29,171
2000,51,1803.0,116,11.6,197,1803
10000,51,9041.0,136,13.6,959,9041
20000,51,18063.0,137,13.7,1937,18063
40000,51,36045.0,138,13.8,3955,36045
60000,51,54084.0,141,14.1,5916,54084
80000,51,72079.0,141,14.1,7921,72079
100000,51,90065.0,180,18.0,9935,90065
2,52,2.0,1,0.1,0,2
3,52,3.0,2,0.2,0,3
100,52,89.0,38,3.8,11,89
200,52,179.0,64,6.4,21,179
2000,52,1775.0,170,17.0,225,1775
10000,52,8976.0,274,27.4,1024,8976
20000,52,18014.0,276,27.6,1986,18014
40000,52,36048.0,282,28.2,3952,36048
60000,52,54028.0,303,30.3,5972,54028
80000,52,71989.0,306,30.6,8011,71989
100000,52,89990.0,307,30.7,10010,89990
2,53,2.0,1,0.1,0,2
3,53,3.0,2,0.2,0,3
100,53,84.0,26,2.6,16,84
200,53,168.0,40,4.0,32,168
2000,53,1795.0,88,8.8,205,1795
10000,53,8979.0,163,16.3,1021,8979
20000,53,17974.0,221,22.1,2026,17974
40000,53,35964.0,243,24.3,4036,35964
60000,53,53909.0,258,25.8,6091,53909
80000,53,71923.0,258,25.8,8077,71923
100000,53,89852.0,266,26.6,10148,89852
2,54,1.0,1,0.1,1,1
3,54,2.0,1,0.1,1,2
100,54,89.0,34,3.4,11,89
200,54,175.0,54,5.4,25,175
2000,54,1789.0,229,22.9,211,1789
10000,54,8961.0,303,30.3,1039,8961
20000,54,17903.0,356,35.6,2097,17903
40000,54,35846.0,358,35.8,4154,35846
60000,54,53792.0,360,36.0,6208,53792
80000,54,71810.0,360,36.0,8190,71810
100000,54,89774.0,360,36.0,10226,89774
2,55,2.0,1,0.1,0,2
3,55,3.0,2,0.2,0,3
100,55,85.0,24,2.4,15,85
200,55,166.0,39,3.9,34,166
2000,55,1791.0,53,5.3,209,1791
10000,55,9035.0,79,7.9,965,9035
20000,55,18035.0,80,8.0,1965,18035
40000,55,36051.0,80,8.0,3949,36051
60000,55,53995.0,82,8.2,6005,53995
80000,55,71956.0,82,8.2,8044,71956
100000,55,90023.0,82,8.2,9977,90023
2,56,2.0,1,0.1,0,2
3,56,3.0,2,0.2,0,3
100,56,90.0,41,4.1,10,90
200,56,182.0,61,6.1,18,182
2000,56,1799.0,213,21.3,201,1799
10000,56,8940.0,373,37.3,1060,8940
20000,56,17957.0,399,39.9,2043,17957
40000,56,35921.0,428,42.8,4079,35921
60000,56,53923.0,492,49.2,6077,53923
80000,56,71970.0,492,49.2,8030,71970
100000,56,89954.0,494,49.4,10046,89954
2,57,1.0,1,0.1,1,1
3,57,2.0,1,0.1,1,2
100,57,81.0,31,3.1,19,81
200,57,172.0,60,6.0,28,172
2000,57,1777.0,201,20.1,223,1777
10000,57,8949.0,253,25.3,1051,8949
20000,57,17980.0,278,27.8,2020,17980
40000,57,36006.0,281,28.1,3994,36006
60000,57,53985.0,288,28.8,6015,53985
80000,57,71929.0,291,29.1,8071,71929
100000,57,89898.0,299,29.9,10102,89898
2,58,1.0,1,0.1,1,1
3,58,1.0,2,0.2,2,1
100,58,86.0,48,4.8,14,86
200,58,171.0,73,7.3,29,171
2000,58,1796.0,222,22.2,204,1796
10000,58,9030.0,280,28.0,970,9030
20000,58,18048.0,314,31.4,1952,18048
40000,58,36017.0,343,34.3,3983,36017
60000,58,54028.0,349,34.9,5972,54028
80000,58,72054.0,349,34.9,7946,72054
100000,58,90028.0,355,35.5,9972,90028
2,59,2.0,1,0.1,0,2
3,59,3.0,2,0.2,0,3
100,59,91.0,50,5.0,9,91
200,59,180.0,73,7.3,20,180
2000,59,1785.0,223,22.3,215,1785
10000,59,9010.0,271,27.1,990,9010
20000,59,18021.0,378,37.8,1979,18021
40000,59,36023.0,383,38.3,3977,36023
60000,59,54046.0,415,41.5,5954,54046
80000,59,72001.0,416,41.6,7999,72001
100000,59,89937.0,418,41.8,10063,89937
2,60,2.0,1,0.1,0,2
3,60,3.0,2,0.2,0,3
100,60,83.0,44,4.4,17,83
200,60,165.0,114,11.4,35,165
2000,60,1782.0,239,23.9,218,1782
10000,60,8998.0,356,35.6,1002,8998
20000,60,18048.0,360,36.0,1952,18048
40000,60,35983.0,433,43.3,4017,35983
60000,60,54031.0,456,45.6,5969,54031
80000,60,72010.0,458,45.8,7990,72010
100000,60,90007.0,460,46.0,9993,90007
2,61,1.0,1,0.1,1,1
3,61,2.0,1,0.1,1,2
100,61,89.0,17,1.7,11,89
200,61,180.0,76,7.6,20,180
2000,61,1752.0,381,38.1,248,1752
10000,61,8942.0,457,45.7,1058,8942
20000,61,18004.0,458,45.8,1996,18004
40000,61,35961.0,486,48.6,4039,35961
60000,61,53969.0,489,48.9,6031,53969
80000,61,71977.0,494,49.4,8023,71977
100000,61,90016.0,498,49.8,9984,90016
2,62,1.0,1,0.1,1,1
3,62,2.0,2,0.2,1,2
100,62,91.0,44,4.4,9,91
200,62,180.0,65,6.5,20,180
2000,62,1768.0,276,27.6,232,1768
10000,62,8965.0,410,41.0,1035,8965
20000,62,17996.0,494,49.4,2004,17996
40000,62,35936.0,530,53.0,4064,35936
60000,62,53937.0,538,53.8,6063,53937
80000,62,71903.0,544,54.4,8097,71903
100000,62,89961.0,544,54.4,10039,89961
2,63,2.0,1,0.1,0,2
3,63,3.0,2,0.2,0,3
100,63,88.0,52,5.2,12,88
200,63,177.0,87,8.7,23,177
2000,63,1772.0,218,21.8,228,1772
10000,63,8956.0,370,37.0,1044,8956
20000,63,17979.0,395,39.5,2021,17979
40000,63,35994.0,505,50.5,4006,35994
60000,63,53997.0,509,50.9,6003,53997
80000,63,71952.0,521,52.1,8048,71952
100000,63,89908.0,529,52.9,10092,89908
2,64,2.0,1,0.1,0,2
3,64,2.0,2,0.2,1,2
100,64,92.0,39,3.9,8,92
200,64,186.0,78,7.8,14,186
2000,64,1791.0,261,26.1,209,1791
10000,64,8961.0,334,33.4,1039,8961
20000,64,17977.0,349,34.9,2023,17977
40000,64,35968.0,413,41.3,4032,35968
60000,64,53932.0,424,42.4,6068,53932
80000,64,71934.0,438,43.8,8066,71934
100000,64,89949.0,438,43.8,10051,89949
2,65,2.0,1,0.1,0,2
3,65,3.0,2,0.2,0,3
100,65,87.0,28,2.8,13,87
200,65,167.0,57,5.7,33,167
2000,65,1765.0,197,19.7,235,1765
10000,65,8990.0,204,20.4,1010,8990
20000,65,17993.0,233,23.3,2007,17993
40000,65,35960.0,252,25.2,4040,35960
60000,65,53994.0,266,26.6,6006,53994
80000,65,71987.0,266,26.6,8013,71987
100000,65,89920.0,270,27.0,10080,89920
2,66,2.0,1,0.1,0,2
3,66,3.0,2,0.2,0,3
100,66,92.0,39,3.9,8,92
200,66,178.0,61,6.1,22,178
2000,66,1757.0,338,33.8,243,1757
10000,66,9003.0,374,37.4,997,9003
20000,66,18001.0,502,50.2,1999,18001
40000,66,35951.0,533,53.3,4049,35951
60000,66,53990.0,535,53.5,6010,53990
80000,66,72054.0,536,53.6,7946,72054
100000,66,90043.0,536,53.6,9957,90043
2,67,2.0,1,0.1,0,2
3,67,3.0,2,0.2,0,3
100,67,87.0,48,4.8,13,87
200,67,174.0,85,8.5,26,174
2000,67,1790.0,215,21.5,210,1790
10000,67,8966.0,319,31.9,1034,8966
20000,67,17943.0,396,39.6,2057,17943
40000,67,35963.0,408,40.8,4037,35963
60000,67,53947.0,409,40.9,6053,53947
80000,67,71906.0,412,41.2,8094,71906
100000,67,89948.0,444,44.4,10052,89948
2,68,2.0,1,0.1,0,2
3,68,3.0,2,0.2,0,3
100,68,90.0,41,4.1,10,90
200,68,179.0,66,6.6,21,179
2000,68,1776.0,250,25.0,224,1776
10000,68,8964.0,372,37.2,1036,8964
20000,68,18008.0,375,37.5,1992,18008
40000,68,36041.0,378,37.8,3959,36041
60000,68,54064.0,393,39.3,5936,54064
80000,68,72073.0,394,39.4,7927,72073
100000,68,90039.0,394,39.4,9961,90039
2,69,2.0,1,0.1,0,2
3,69,3.0,2,0.2,0,3
100,69,90.0,28,2.8,10,90
200,69,172.0,33,3.3,28,172
2000,69,1781.0,127,12.7,219,1781
10000,69,8970.0,167,16.7,1030,8970
20000,69,17907.0,221,22.1,2093,17907
40000,69,35927.0,223,22.3,4073,35927
60000,69,53868.0,232,23.2,6132,53868
80000,69,71861.0,232,23.2,8139,71861
100000,69,89895.0,232,23.2,10105,89895
2,70,2.0,1,0.1,0,2
3,70,2.0,2,0.2,1,2
100,70,88.0,38,3.8,12,88
200,70,173.0,105,10.5,27,173
2000,70,1762.0,306,30.6,238,1762
10000,70,8983.0,451,45.1,1017,8983
20000,70,17992.0,501,50.1,2008,17992
40000,70,36022.0,506,50.6,3978,36022
60000,70,53915.0,538,53.8,6085,53915
80000,70,71999.0,538,53.8,8001,71999
100000,70,89973.0,540,54.0,10027,89973
2,71,2.0,1,0.1,0,2
3,71,3.0,2,0.2,0,3
100,71,84.0,50,5.0,16,84
200,71,175.0,75,7.5,25,175
2000,71,1771.0,235,23.5,229,1771
10000,71,8981.0,250,25.0,1019,8981
20000,71,17969.0,289,28.9,2031,17969
40000,71,35966.0,304,30.4,4034,35966
60000,71,53869.0,445,44.5,6131,53869
80000,71,71811.0,446,44.6,8189,71811
100000,71,89755.0,446,44.6,10245,89755
2,72,2.0,1,0.1,0,2
3,72,3.0,2,0.2,0,3
100,72,83.0,13,1.3,17,83
200,72,173.0,34,3.4,27,173
2000,72,1779.0,111,11.1,221,1779
10000,72,8998.0,121,12.1,1002,8998
20000,72,17987.0,127,12.7,2013,17987
40000,72,35943.0,148,14.8,4057,35943
60000,72,53968.0,149,14.9,6032,53968
80000,72,72010.0,149,14.9,7990,72010
100000,72,90013.0,149,14.9,9987,90013
2,73,1.0,1,0.1,1,1
3,73,2.0,1,0.1,1,2
100,73,90.0,35,3.5,10,90
200,73,179.0,48,4.8,21,179
2000,73,1778.0,100,10.0,222,1778
10000,73,8978.0,114,11.4,1022,8978
20000,73,18026.0,114,11.4,1974,18026
40000,73,36057.0,116,11.6,3943,36057
60000,73,54068.0,117,11.7,5932,54068
80000,73,72104.0,117,11.7,7896,72104
100000,73,90048.0,117,11.7,9952,90048
2,74,1.0,1,0.1,1,1
3,74,2.0,1,0.1,1,2
100,74,90.0,35,3.5,10,90
200,74,178.0,74,7.4,22,178
2000,74,1787.0,161,16.1,213,1787
10000,74,8991.0,197,19.7,1009,8991
20000,74,18017.0,198,19.8,1983,18017
40000,74,36021.0,201,20.1,3979,36021
60000,74,54051.0,201,20.1,5949,54051
80000,74,72152.0,201,20.1,7848,72152
100000,74,90177.0,224,22.4,9823,90177
2,75,2.0,1,0.1,0,2
3,75,2.0,2,0.2,1,2
100,75,90.0,35,3.5,10,90
200,75,178.0,59,5.9,22,178
2000,75,1773.0,249,24.9,227,1773
10000,75,8975.0,321,32.1,1025,8975
20000,75,17924.0,362,36.2,2076,17924
40000,75,35870.0,366,36.6,4130,35870
60000,75,53885.0,382,38.2,6115,53885
80000,75,71829.0,382,38.2,8171,71829
100000,75,89817.0,385,38.5,10183,89817
2,76,2.0,1,0.1,0,2
3,76,2.0,2,0.2,1,2
100,76,84.0,13,1.3,16,84
200,76,176.0,61,6.1,24,176
2000,76,1797.0,125,12.5,203,1797
10000,76,8957.0,161,16.1,1043,8957
20000,76,17937.0,191,19.1,2063,17937
40000,76,35978.0,200,20.0,4022,35978
60000,76,53993.0,200,20.0,6007,53993
80000,76,72030.0,202,20.2,7970,72030
100000,76,90074.0,202,20.2,9926,90074
2,77,2.0,1,0.1,0,2
3,77,2.0,2,0.2,1,2
100,77,88.0,37,3.7,12,88
200,77,169.0,73,7.3,31,169
2000,77,1789.0,244,24.4,211,1789
10000,77,9048.0,272,27.2,952,9048
20000,77,18036.0,280,28.0,1964,18036
40000,77,36036.0,351,35.1,3964,36036
60000,77,54044.0,354,35.4,5956,54044
80000,77,72086.0,354,35.4,7914,72086
100000,77,90074.0,354,35.4,9926,90074
2,78,2.0,1,0.1,0,2
3,78,3.0,2,0.2,0,3
100,78,88.0,50,5.0,12,88
200,78,174.0,98,9.8,26,174
2000,78,1781.0,229,22.9,219,1781
10000,78,8994.0,309,30.9,1006,8994
20000,78,17985.0,314,31.4,2015,17985
40000,78,35971.0,318,31.8,4029,35971
60000,78,53988.0,319,31.9,6012,53988
80000,78,72002.0,319,31.9,7998,72002
100000,78,89988.0,320,32.0,10012,89988
2,79,2.0,1,0.1,0,2
3,79,3.0,2,0.2,0,3
100,79,90.0,36,3.6,10,90
200,79,174.0,73,7.3,26,174
2000,79,1798.0,203,20.3,202,1798
10000,79,8942.0,392,39.2,1058,8942
20000,79,17971.0,408,40.8,2029,17971
40000,79,35930.0,501,50.1,4070,35930
60000,79,53899.0,532,53.2,6101,53899
80000,79,71848.0,544,54.4,8152,71848
100000,79,89847.0,544,54.4,10153,89847
2,80,1.0,1,0.1,1,1
3,80,1.0,2,0.2,2,1
100,80,87.0,50,5.0,13,87
200,80,171.0,72,7.2,29,171
2000,80,1791.0,159,15.9,209,1791
10000,80,8968.0,278,27.8,1032,8968
20000,80,17953.0,281,28.1,2047,17953
40000,80,35869.0,323,32.3,4131,35869
60000,80,53945.0,323,32.3,6055,53945
80000,80,71965.0,323,32.3,8035,71965
100000,80,89947.0,323,32.3,10053,89947
2,81,1.0,1,0.1,1,1
3,81,2.0,2,0.2,1,2
100,81,94.0,42,4.2,6,94
200,81,176.0,73,7.3,24,176
2000,81,1776.0,185,18.5,224,1776
10000,81,8950.0,242,24.2,1050,8950
20000,81,17968.0,265,26.5,2032,17968
40000,81,35946.0,278,27.8,4054,35946
60000,81,53981.0,279,27.9,6019,53981
80000,81,71993.0,279,27.9,8007,71993
100000,81,89921.0,283,28.3,10079,89921
2,82,2.0,1,0.1,0,2
3,82,3.0,2,0.2,0,3
100,82,88.0,34,3.4,12,88
200,82,174.0,51,5.1,26,174
2000,82,1806.0,107,10.7,194,1806
10000,82,9018.0,162,16.2,982,9018
20000,82,18033.0,173,17.3,1967,18033
40000,82,35955.0,195,19.5,4045,35955
60000,82,54042.0,195,19.5,5958,54042
80000,82,72051.0,197,19.7,7949,72051
100000,82,90051.0,197,19.7,9949,90051
2,83,2.0,1,0.1,0,2
3,83,2.0,2,0.2,1,2
100,83,83.0,17,1.7,17,83
200,83,171.0,23,2.3,29,171
2000,83,1787.0,130,13.0,213,1787
10000,83,8995.0,272,27.2,1005,8995
20000,83,18063.0,273,27.3,1937,18063
40000,83,36081.0,309,30.9,3919,36081
60000,83,54051.0,362,36.2,5949,54051
80000,83,72091.0,362,36.2,7909,72091
100000,83,90196.0,362,36.2,9804,90196
2,84,1.0,1,0.1,1,1
3,84,2.0,1,0.1,1,2
100,84,87.0,17,1.7,13,87
200,84,166.0,69,6.9,34,166
2000,84,1756.0,178,17.8,244,1756
10000,84,8941.0,242,24.2,1059,8941
20000,84,17887.0,366,36.6,2113,17887
40000,84,35831.0,369,36.9,4169,35831
60000,84,53827.0,369,36.9,6173,53827
80000,84,71782.0,373,37.3,8218,71782
100000,84,89776.0,373,37.3,10224,89776
2,85,2.0,1,0.1,0,2
3,85,3.0,2,0.2,0,3
100,85,86.0,39,3.9,14,86
200,85,175.0,52,5.2,25,175
2000,85,1801.0,113,11.3,199,1801
10000,85,8982.0,550,55.0,1018,8982
20000,85,18001.0,619,61.9,1999,18001
40000,85,36056.0,642,64.2,3944,36056
60000,85,54066.0,666,66.6,5934,54066
80000,85,72104.0,811,81.1,7896,72104
100000,85,90102.0,813,81.3,9898,90102
2,86,1.0,1,0.1,1,1
3,86,2.0,1,0.1,1,2
100,86,84.0,36,3.6,16,84
200,86,168.0,48,4.8,32,168
2000,86,1760.0,177,17.7,240,1760
10000,86,8986.0,236,23.6,1014,8986
20000,86,17997.0,248,24.8,2003,17997
40000,86,36034.0,259,25.9,3966,36034
60000,86,54051.0,261,26.1,5949,54051
80000,86,72038.0,261,26.1,7962,72038
100000,86,89942.0,291,29.1,10058,89942
2,87,2.0,1,0.1,0,2
3,87,3.0,2,0.2,0,3
100,87,89.0,38,3.8,11,89
200,87,180.0,59,5.9,20,180
2000,87,1798.0,180,18.0,202,1798
10000,87,9000.0,254,25.4,1000,9000
20000,87,18047.0,298,29.8,1953,18047
40000,87,36040.0,442,44.2,3960,36040
60000,87,54034.0,454,45.4,5966,54034
80000,87,72015.0,457,45.7,7985,72015
100000,87,90063.0,457,45.7,9937,90063
2,88,2.0,1,0.1,0,2
3,88,2.0,2,0.2,1,2
100,88,90.0,35,3.5,10,90
200,88,181.0,75,7.5,19,181
2000,88,1797.0,168,16.8,203,1797
10000,88,9004.0,206,20.6,996,9004
20000,88,17945.0,250,25.0,2055,17945
40000,88,35971.0,265,26.5,4029,35971
60000,88,53986.0,270,27.0,6014,53986
80000,88,71843.0,284,28.4,8157,71843
100000,88,89838.0,289,28.9,10162,89838
2,89,1.0,1,0.1,1,1
3,89,2.0,1,0.1,1,2
100,89,87.0,20,2.0,13,87
200,89,179.0,27,2.7,21,179
2000,89,1781.0,78,7.8,219,1781
10000,89,8999.0,123,12.3,1001,8999
20000,89,18004.0,133,13.3,1996,18004
40000,89,36057.0,133,13.3,3943,36057
60000,89,53937.0,139,13.9,6063,53937
80000,89,71951.0,139,13.9,8049,71951
100000,89,89958.0,139,13.9,10042,89958
2,90,2.0,1,0.1,0,2
3,90,2.0,2,0.2,1,2
100,90,88.0,33,3.3,12,88
200,90,172.0,63,6.3,28,172
2000,90,1794.0,227,22.7,206,1794
10000,90,8989.0,446,44.6,1011,8989
20000,90,18004.0,452,45.2,1996,18004
40000,90,36016.0,485,48.5,3984,36016
60000,90,53967.0,487,48.7,6033,53967
80000,90,72026.0,487,48.7,7974,72026
100000,90,89949.0,488,48.8,10051,89949
2,91,1.0,1,0.1,1,1
3,91,1.0,1,0.1,2,1
100,91,90.0,26,2.6,10,90
200,91,175.0,37,3.7,25,175
2000,91,1763.0,155,15.5,237,1763
10000,91,8965.0,186,18.6,1035,8965
20000,91,18006.0,187,18.7,1994,18006
40000,91,35951.0,192,19.2,4049,35951
60000,91,53953.0,192,19.2,6047,53953
80000,91,71971.0,192,19.2,8029,71971
100000,91,90075.0,192,19.2,9925,90075
2,92,2.0,1,0.1,0,2
3,92,3.0,2,0.2,0,3
100,92,88.0,50,5.0,12,88
200,92,177.0,65,6.5,23,177
2000,92,1827.0,164,16.4,173,1827
10000,92,8981.0,281,28.1,1019,8981
20000,92,18011.0,290,29.0,1989,18011
40000,92,36012.0,294,29.4,3988,36012
60000,92,54067.0,296,29.6,5933,54067
80000,92,72064.0,298,29.8,7936,72064
100000,92,90028.0,298,29.8,9972,90028
2,93,2.0,1,0.1,0,2
3,93,3.0,2,0.2,0,3
100,93,89.0,33,3.3,11,89
200,93,172.0,49,4.9,28,172
2000,93,1769.0,161,16.1,231,1769
10000,93,8980.0,245,24.5,1020,8980
20000,93,17977.0,260,26.0,2023,17977
40000,93,36000.0,267,26.7,4000,36000
60000,93,54016.0,282,28.2,5984,54016
80000,93,72047.0,296,29.6,7953,72047
100000,93,90070.0,296,29.6,9930,90070
2,94,1.0,1,0.1,1,1
3,94,1.0,2,0.2,2,1
100,94,90.0,23,2.3,10,90
200,94,176.0,37,3.7,24,176
2000,94,1798.0,73,7.3,202,1798
10000,94,8985.0,78,7.8,1015,8985
20000,94,17991.0,79,7.9,2009,17991
40000,94,35968.0,79,7.9,4032,35968
60000,94,53918.0,80,8.0,6082,53918
80000,94,71974.0,80,8.0,8026,71974
100000,94,90028.0,80,8.0,9972,90028
2,95,2.0,1,0.1,0,2
3,95,3.0,2,0.2,0,3
100,95,82.0,39,3.9,18,82
200,95,174.0,50,5.0,26,174
2000,95,1787.0,145,14.5,213,1787
10000,95,9014.0,164,16.4,986,9014
20000,95,18017.0,171,17.1,1983,18017
40000,95,36031.0,201,20.1,3969,36031
60000,95,54009.0,217,21.7,5991,54009
80000,95,72059.0,217,21.7,7941,72059
100000,95,90034.0,219,21.9,9966,90034
2,96,2.0,1,0.1,0,2
3,96,3.0,2,0.2,0,3
100,96,85.0,44,4.4,15,85
200,96,174.0,77,7.7,26,174
2000,96,1783.0,181,18.1,217,1783
10000,96,9004.0,205,20.5,996,9004
20000,96,18031.0,211,21.1,1969,18031
40000,96,36004.0,222,22.2,3996,36004
60000,96,54085.0,223,22.3,5915,54085
80000,96,72112.0,223,22.3,7888,72112
100000,96,90194.0,223,22.3,9806,90194
2,97,1.0,1,0.1,1,1
3,97,2.0,1,0.1,1,2
100,97,86.0,15,1.5,14,86
200,97,178.0,20,2.0,22,178
2000,97,1779.0,135,13.5,221,1779
10000,97,8973.0,160,16.0,1027,8973
20000,97,17994.0,166,16.6,2006,17994
40000,97,35945.0,168,16.8,4055,35945
60000,97,54007.0,168,16.8,5993,54007
80000,97,71954.0,168,16.8,8046,71954
100000,97,89884.0,169,16.9,10116,89884
2,98,2.0,1,0.1,0,2
3,98,3.0,2,0.2,0,3
100,98,90.0,38,3.8,10,90
200,98,175.0,76,7.6,25,175
2000,98,1799.0,269,26.9,201,1799
10000,98,9017.0,360,36.0,983,9017
20000,98,17955.0,395,39.5,2045,17955
40000,98,35956.0,398,39.8,4044,35956
60000,98,54004.0,398,39.8,5996,54004
80000,98,72028.0,402,40.2,7972,72028
100000,98,89974.0,403,40.3,10026,89974
2,99,2.0,1,0.1,0,2
3,99,2.0,2,0.2,1,2
100,99,90.0,51,5.1,10,90
200,99,177.0,70,7.0,23,177
2000,99,1782.0,321,32.1,218,1782
10000,99,8932.0,406,40.6,1068,8932
20000,99,17930.0,479,47.9,2070,17930
40000,99,35905.0,497,49.7,4095,35905
60000,99,53917.0,499,49.9,6083,53917
80000,99,71938.0,499,49.9,8062,71938
100000,99,89883.0,500,50.0,10117,89883
2,100,0.0,1,0.1,2,0
3,100,0.0,2,0.2,3,0
100,100,86.0,49,4.9,14,86
200,100,169.0,94,9.4,31,169
2000,100,1783.0,324,32.4,217,1783
10000,100,8971.0,467,46.7,1029,8971
20000,100,17945.0,506,50.6,2055,17945
40000,100,35966.0,512,51.2,4034,35966
60000,100,53941.0,543,54.3,6059,53941
80000,100,72023.0,543,54.3,7977,72023
100000,100,90036.0,543,54.3,9964,90036
